لا تزال نخفق عل السفائن غادية عل سواحل الروم للغزو ، أو مرفرفة أب 	
فوق رءوس الجند ف البرية لبيات العدو ... ولسكن مسلة - إلى كل 	
ذلك - من أبناء الجوارى؛ فسكيف يليها ابن الرومية و محرمهما أبناء 	
ر ير من بنات عبس ومخزوم وأممة ؟ . 	ال إم 	
أقيمت حلة الساق فى ظاهر دمشق عل العادة في كل موسه ، وتقدم 	
فتيان العرب بأفراسهم المضمرة يطمع كلى منهم أن ينال بالسمق جائزة 	
امير المؤ منين عيد الملك وجلس ع.د الملك على رف ف طرف الحلبة 	
قد اقه له سرادى من خز و اصدت عل رأسه راية بيضاء؛ وآن الشوط 	
و لبارن ، 	الأول للأما من ينى عبد الملك : الوليد، ومسلة، س 	
و يزد، وهرام . 	
وأشار رائض اللة إشارته، فرئب الأمراء عل ظهور الياد 	
ما لوا عل الأءناق ، يتبعهم الالاف إميون جاحظة 	وشدوا اللج و 	
وانفاس مهورة وأعناق تتلوى عل كواهل أجابها: وبدا كأن ملرة 	
بلغ7 الك ط قبل إخوته ، فبدت لـكراهة فى وجه عبد الملك ، 	
. اللبة هتاف ابلجاهير اسه الأمير المظفر 	لث من جو اس 	عل حين ١". 	
ى كل غزاة : مسلهة ين عرد الملك ! 	
د يمض 	اكبه ، ثم لمع 	والكن فرس مسلة لم يلبث أن عر ب 	
اف عد وه حى سرقه إخوته بميما و لغوا آخر امدى ! 	ليستأ 	
طأطأ مسلية رأسه أسفا وهو يتقدم فى صف من إخوته إلى مجاس 	
٢٢ 	
