ابن أخأ كدت الحادثات فسبه 	
لا زال معروفك يطوق عنق بامولاى ! 	
وأوشكت الدءوع أن تنبثق من عينى الأمير ، فهب واققا ومال 	
خممته حدتوز عتهأيجانه ! 	- فاستأذن منصرها إل 	بوجهه ناحية : وناض مى 	
وارتى رثياه عل فراشه مكدود النفس ، وحملق بالوم فى أجواء 	
مه ع عوت حوسى لعوه. 	مث أن انتمه من سر 	نه ما 	لعمدة . ٠ ٠وـ 	
ثا نية إلى لقاء الأمير ولم تمض ساعة منذ غادر مجلسه ذاك ؛ وكان أحد 	
العر بيين الطايقين فى بمجلس الأمير وقد أبدل ثيابا بثياب وسو ى شعره 	
ر ر غيد ما ان منذ قليل . 	وأى شاره فيدا فى م:ظ آ 	
- مو فى ! 	
أتعرف هذا العرنى اعتية ؟ 	
أحد الرجاين اللذين كانا... 	
لعم ، قهلا عرفت أسمه ؟ 	
- وما يكون اسمه ؟ 	
قال الرجل متميا : 	
عتية ين عيد الله الرق ا 	
مى ، ابو نوار ا 	
من نوار ؟ إما أبا أيو بشير ا 	
نوار اخت بشير 	
٤٢ 	
