وقلت له ... وقال لك ... 	
لم أستمع إلى قول منه أو يستمع إلى قول «ى !... 	
تغاضتنا إذن ؟ 	
أنا مسلمة ين عد املك وهو 	• ث 	بحن متغاض -ان م:ذكنا 	
قسططين وحسب ! 	
ولكنه أبو أمك ! 	
قد كان ذلك يوما ، أما الموم فلست منه ولاس مف أ 	
وإذن ف يغير من رأيك شيثا أن عرفت هذا السر ؟ 	
بل قد أجد لى عزما جدبدا .. 	
وما ذاك ؟ 	
ان لمسلة بن عمد الملك حقا فى عرش القياصرة ، فسأحارب الروم 	
منذ اليوم عل عرش قسطنطن لأستخلصه لنفسى غير غاصب .... 	
عق أمومتك ! 	
الان طارت نمسى با مسلة ! 	
آبائك وآ لك ؟ 	طارت نفسك بتقو يض عرش القاصرة من 	
ذلك ثىء آخر ! 	
فاذا لعنين إذن q 	
أمك - أن تطفا فى قلبك 	عر وت 	لقد كنت أخشى يا ملهة - لو 	
أسباب المهد 	جذوة الماسة لحرب الروم ، وه كل ما تلك يا بنني من 	
أبناء عمد املك ؛ فالآن قد أمنت وطابت نهى 	حون زتماخر 	
