والتفت مسلمة إلى حيت ان النعان فرآه فعرفه فمدأه محسا : 	
اك با أنا عتيية ! 	ما ر2ه 	طا - 	أد 	
طابت لك الرحلة والاقامة با مولاى ! 	
الافافة من إغفاءة حالمة مثل إغفاءة صاجه ، 	وتان مسلمة قريت 	
ما ضمه و حاضره وصور أخرى 	قد رأى فيها ربا وانسكشفت لهصور من 	
قيل : وكان النعان يصحيه في كل مراحل الريا ، فل يكد 	- ٥ ٠ 	
أخذه العج ، 	يفيق من إغفاءته وبرى انعيان إلى جانب راجاته حتى 	
فقال وى صوته نبر غريب : 	
لأم ما رأيتك إلى، جانى الساعة ا أا عتيبة ! 	
نا ا ولاى فرغيت ... 	اقد رأيت رق . 	
روا؟.. 	
نه ، وآن الأمير ممى .. 	
- معك 	
أعبى أنى كنت معه... 	
له ، له ا 	
ورأيتك تضم إليك شاا فيه ملاج من أبيه فتتملاه طو يلا ثم 	
ولم أكن مدا بدد ذلك ولسكى رأيت كل 	ك بالدموع .. . 	بمض 	
ما كان وعروت ... 	
قال مسلمة الذاهل : 	
اس، كيف حدث هذا ؟ ... 	ل ل . و . ن 	
