ا 	تملك جزائرهم فى البحر ، وتأخذ عليهم طر يقهم 	وتدك حصوهم، و 	
إإى 	هذه الا ناها قسطنطين الأرل وانخذها 	فى البر، ولطوق مديذهم ى . 	
قاعدة لملك؛ فلا يزالون عل حصارها سنين ذات عدد ، لا يصدر 	
وا 	"لغ الجهد بقسطنطين وأهل ملته ما يبلغ ، 	ى 	منها ولا يرد إليها ، 	
فر 	فيعطى الجزية صاغرا ... ويعود المسلون ظافرين لم يتخلف من و و ساهم 	
غير أى أيوب ، هد د فن عند سور القسطنطينية ا وعده رسول الله ! 	
«رد الله غرتك ا أبا أيوب ا 	
«مضيف رسول الله أول جرته إلى المدينة قد ثوى نحت أسوار 	
القسطنطينية ضيفا عل أهل الـكفر ! 	
نا أبناء الأنصار من 	ا أنناء المهاجرين من نيرف أى أيوب ، 	
محابته ؛ إن أا أيوب لم يزل كر بما كعهدك به ؛ فهاجروا إليه يضيفك 	
في داره الجديدة كا ضيف نبيك ممدا منذ سنين سلفت ! ، 	
حديث الث . شخاف قلمه : 	هتف عمسه بن عسد الله وهد مس 	
لك أبا أيوب ا 	
فضج الجلس وراءه التلبية ... 	
ذلك شأن القاص أى داود وذلك شأن الناس معه : لا رزال 	
يتتقل بين الأمصار ، يدعو إلى ابلجاعة أو بدعو إلى جهاد أهل الشرك ؛ 	
فيستجب له من يستج وبط لى 	
ولكن الفتنة الى نشبت بين أهلى القرآن منذ سنين لم تطفأ بمد ؛ 	
فلا يزال فى كل بلد داع بدعو لتفسه ويؤازره من المسلمين طائفة فأمير 	
٢ 	
