ثم آب إلى القسطنطينية . .. 	
وأخذ الرهن دب فى قوى الروم، فل يجدوا بدا من النزول عل. 	
"وا إلى مسلة فى وقف القتال وفك احصار عل أن 	طاله ب؛ فمه. 	م 	
يؤدرا إليه الجرة عن كل رأس دينارا؛ ولسكن ملة أى، فبعثوا 	
إليه ثانية يطلبون أن يوفد إليهم إليرن الروى ليفاوضوه فى شروط 	
.و وأوفد إلهم صاحبهم 	التسلي ؛ فأجاهم مسلة إلى ما طله ا 	
ما أجدر هذا الرومى أن يشرح الله صدره للإسلام فيكون. 	
ا ناجا ! » 	أحا محة ووزير 	
كذلك قال مسلمة انفسه وقد ذهب إليون إلى قومه ليفاوضهم فى. 	
س يمرع مسلهة اليوم 	؛ فمدونة هذا الروى الطس النه 	شروط التسليم . 	
لا شك ـ داخلها غدا: فيطأ بلاط 	" ططنية؛ وهو 	يو دسه ه 	
اس عل عرش قسطنطين ، فيجهر الاذار عل هذه 	ص z»,.c9 	
كامة الله من. 	ذ 	الأوار المنيعة، فيؤم جنده فى الصلاة بأاصوةا 	
مة فى الأرض السكبيرة، فيمضى قدما حى يطأ رومية، وجوس ى 	
لاد إفرفسة ، وينفذ إلى الأندلس من المشرق ، ويقف عل شاطح 	
الأقمانوس الأخضر موقفا وقف مثله عقمة ين اجح منذ سنين ... 	
« ذاك والله كله بفضل إليون المرءشى... وإن فى الروم لذوى 	
أعراق طيبة وإن كأن آباؤه من ذوى المهنة ا 	
ردد مسلمة هذه العارة كذلك فيا بينه وبين نفسه ؛ وأبا ذكر 	
٢٠ 	
