إس يا بني صاحب اللواء فىهذه الدولة؛ لا تزال تقود الجند 	
، حى أرهقت الروم 	لحرب الروم فتثخن فيهم قتلا وتجرجا وأسرا 	
من أمره عسرا؛ فهل تجد يا بنى راحة نفس فيا تفعل من ذلك ؟ 	
نه يا أم ! 	
اذا ء فت أن ف هؤلاء الروم مولتك ؟ 	- بء ر 	فكف لصن 	
قد عرفت ذلك منذ بعيد ... أخهذا هو السر الذى تطون عنى ؟ 	
لع با مسلمة ! 	
ليس ذاك ... 	
- نر بد أن أزيدك يا مسلة ؟ 	
- فاعل - وعليك وحدك تبعة هذا العلـ أنك تركب من الأم 	
عظيا فى حرب الروم ا 	
ماذا لعنين ؟ 	
انت تطاب رأس جدك ! 	
جدى ؟ 	
نمم، أف -- 	
ولا تزالين تذكرين أباك يا أم ؟ ... 	
، انه بعنى منذ ساعات ! 	
نم 	
واسمه ! 	
قسطنطين ... 	
