واستسلللشيخ مساوب الإرادة قد مجا هذا اللقاء منرأسه صفحات 	
و ثبت صفحات ... 	
وأوى ه البطريق إلى دار أنيقة فى أبيدوس ، ثم دعا أهله رجلا 	
رجلاو امرأة امرأة ايتعرفوا إلى نسيبهم العرى ، و مثلت بين ندنه امرأة 	
ا سرية ، و مفرقها جوهرة وعل صدرها قلادة ؛ فوث إا سا 	
عتيمة يرد أن يضمها إليه ويسند رأسه إلى كتفها وهر يهتف ذاهلا : 	
- أى سبيية ! 	
ح وربت تفه . 	قال الم 	
تلك خالتك بابى ، توءمة لأمك ، وما كأن اسه أمك سبيكة يوم 	
ت سحر 	يوم أن يكون اسمها سبي ! ل 	ذهت ، واركى أوثر منذ ل 	
ر سم ح «روديا» ف نيت سدها ؟ 	كيف صا ا أ- 	
فال الفى . 	
- ومن تكون رود يا هذه با أد. ؟ 	
بذت أخرى، استاها الغزاة فى غارة معاوية l ... 	
وغاب عنك خبرها من يومذ ؟ 	
وعاب عنى خرها من يو ممن 	
ولا أثر بدل عليها ؟ 	
جوهرة وقلادة كذلك ! 	
و جاءت امرأة البطر يق فضمت عتية إلى صدرهاف حنان و ه لصيح: 	
ابيف ! ان 	
١٣٩ 	
