أتذ كرانه ا بذكرهما وبذ كرهما معه الاخوة والأحوات وبنو 	
استدلتا فى العرب أهلا بأهل وباعتا بالسد 	أم 	، الأعام والعات ؛ 	
ر مو حدء والأسوا 	والولد الا .- الا الألا - 	
عل ظهر أى البلاد تعيشان ، أو فى بطن أى الارض قد سوى 	
. علهما التراب ؟ 	
أبذتا المطر يق المعظم ، جار يتان"قد انقطعت بينهو بينهماالأسبان . 	
اله من ذاءة بعض وومه !. 	الجعة في اذتهه ، و 	ياله من 	
قال أنسطاثيومس الماع : 	
هر ن عليك اقهطنطين ؛ فقد عل والله كل روى فى هذه البلاد 	
بلاءك فى وساد هؤلاء الهرب ؛ فلا علرك من قول لم مل عليه 	
إلا الغيرة ! 	
و بو يع أنسطاثيوس قيصرا، فراح حاول ما حاول لندبير ار 	
المتتابعة لمم تدع له 	ر ر ر ف 	البلاد و تنهاه توات الدفاع ، ولكن غا ١ - ١١٩ 	
فرهة للتدبير ولا لتزا قوات الدفاع ، فنالوا منه ولملمنهم و والت 	
هزابمه فى البر والبجر ؛ فاعزل العرش إلى بهض الأدبار حزينا أسوان 	
يلتمس فى الصلاة والدعاه بهض الساوان ! 	
وونب إلى المرش وق آشر كان جابيا للخراج فى لعض الأقالم . 	
فظ تـكن حال البلاد فى عهده خيرا منها فى عهد أسلافه ؛ واضطرب به 	
الأم وأحاطت ه الأحداث ... 	
٨٥ 	
