مروان جيما ! 	
ولكن عيد العزيز لا يلث أن بجىء لعسه من مصر وتنحل العقدة 	
المستعصية ، فيجعلعمد الملك عوده من بعده اولديه : الو ليد: مم سلان ، 	
أبى ولادة العدسة ! 	
" السعة للأ مير ين ، و محلف لهيا بنو موان و بنو أمية جمهها، -م تو خذ 	
و " 	
الييعة من الأمصار.. 	
و يؤوى عبدالملك إليه أولاده ليقول لهه : 	
دتهوى الله ، فاجا عصمة باقسة ، و جنه 	• يابن عبدالملك ، أو صك 	
حى 	واقمة ؛ وليعطف السكبير منك على الصغير ، وليحرف الصخير منسك 	
الفرقة 	الأخذ ميل الأمرر؛ وليا و 	الـكبير ء مع سلامة الصدور ، و 	
المعظمون . وانظروا 	و د؛ وذل ذوو المز 	والخلاف ؛ فبهما هلك الا لو . 	
مسلة ، فاصدروا عن رأبه ، فإنه بابك الذى منه لعر ون ، و جن الذى 	
ج العقارب ، وكونوا 	ه لستجزون ؛ ولأو نوا وننى ام بررة: وإلا دبت بهنه 	
فى الحرب احرارا ، وللمجروف منارا ... 	
م يقبل عل ابنه الوليد فيقول : 	
"اث رمحن حنين الأمة ، ولكن خر 	لا الفنك إذا مت لعصر عي. 	
ر: ودلى و حفرى وخللى وشأى و ءليك وشأنك ، 	وائزرء والبس جلدالة 	
م ادع الناس للبيعة ؛ فن قال هكذا ؛ فقل بالسيف هكذا . 	
م يعمض عد املك جفنه ! 	
