له 	م رفع عيفيه نول بهما فيمن حو 	صن أبوداود برهة ، 	
وهو بمخلل لحيته أصابعه ، ثم استأنف حديثه : 	
« حدثنا نصر بن عوانة ـ وكان ف وش عقية بن نافع بالمغرب - 	
قال : لقد رأيت عةة وقد بلغ بجيشه شاطع الأقيانوس الأخضر ، فبدفع 	
حصانه إلى البحر ويقول بحاسة : اللهم رب جمد، لولا أى لاأعلم وراء 	
هذا المحر بابة لافتحمت هذا الهول الماج لأذشر اسه مجدك العظيم 	
فى أقصى حدود الدنما ! 	
« رح الله عقمة ! وان مثل عقمة ؟ ذان قسطاطين بن هرقل ما يزال 	
وراء هذه الحدود المتاخمة ، يتهدد أحا ،نا بالغارة بعد الغارة برا وبحرا ، 	
•l إليه لننشر اسم الله المجمد في أقصى بلاد الروم ! ضل من 	قهلا خرج. 	
حعل إلهه هواه ! ألا إنه اولا اين هرقل عل هذه التخوم ما صا 	
- يزعهم - هرقلهة ! » 	
وتلث القاص برهة اخرى ، -ما -أ.. 	
لقد أن معاوة ، وكان ابنه يزبد ، وكان مروان ؛ م كان 	
أمير المؤ منين عيد املك .كأما لم تمض تلك السنون ، وكأى أرى الساعة 	
- م يمودع يزبد ان أمير الم مين ، وفيهم ابن عباس ، 	وأسمع تسكبير جند الها " 	
وابن عدر ، وابن الزبير ، وابوأيوب الأنصارى جار رسولالله ومضيفه 	
فيدار رته؛ قد ركبوا ف عشرات الالاف من الجند، تقلهم 	
سيعائة والف سفنه ود صنعها معاوية إعذه من ارز هذه الغابات 	
الـكثيفة فى جـال لينان ، م أرسلها في البحر لحرب الروم ، تفزو بلادم ، 	
