ا3- و ام موصوا ؟ 	
بغير عفة ! 	م ، واسم 	كل ذلك موصوف بذير ا 	إن 	
فهول ترى من صفتى وصفة صاحى هذا عندك ؟ 	ى 	
أمير يمزى من الإمارة ، أو تعزف عنه الإمارة ؛ ينزع به عرق ، 	ق 	
ذه عرو؛ جرادة صفراء ، بحت راية سضاء ، يف ه لغيره ، 	
له ، عن مينه عل العرش اربعه ، وعن يساره أربعة ؛ ندنو 	مه 	
و لاممع 	
نفاء ١ دعد الأن؛ بينه 	حى يكون قاب قوسين ، فيقف بين بين، ٣. ٣ . 	
م ركون ماأراد، سن لاتاع 	وبين مايأمله متان وميتان وثلاثة : 	
ل بثىء مرن ذلك الراد، إلا عين جارية، وسيرة باقية ؛ وبذكر 	
ب، وابوسعمد، وعمد ين مراد ! . 	. 	
هذا الخليفة الجالس عل العرش ؟ 	
مقه الهيون ، وتتو همه الظنون ، 	أسم صى و ووبصى ، ر 	
الفناء، ويجزل 	٠، وب ع 	وهو مما يراد ه فى حرز مصون ؛ يهل لt 	
معضى ا جاء؛ وخلفه ماك له اء " 	العطاء، ويلد اانجماء ، 	
ووجه وضى ، تفتح عليه بلاد لم يسلكها بدوى ، ولم تطأها قدم 	
الغطاء عن المائدة الضيفان ، إن 	فع 	عرى؛ با سليان بن داود، ار 	
للمأدبة مو عدا قد حان 1... 	
وصت الراهب برهة وأطرق ، ومال مسلية عل أذن رفيقه يس 	
م روع الراهب رأسه يقول : 	إلبه ، 	
ا الجن يذشد ضالة ، والضالة تذشد ناشد ها ؛ والباب 	و ا 	
