عرج دابق عل الطريق إلى بلاد الروم، قد أقسم لايبرحها إلى حاضرته 	
حتى وأتيه الفتح أو بدركه الأجل .. 	
عرب من أسا 	وكان البر يد يتوالى عليه يوما بعد يوم ما بلغ ل 	
ما نال الروم من الجهد والإعياء ، فلا رزال يصل ودءو الله 	النصر و 	
بينه و بين ما أراد إلا غاوة 	ـل إليه أن ايس 	أن يعجل الفتح ، وهد خم 	
سهم ، وأنه أولا حرص مسلة عل دماء المسلدين أن تراق لاقتحمها 	
مخيله ورجله ووطع بساط قمصر منذ بههد! . 	
اله ت بالمكر 	ثم جاءه النبأ بما ٢ ل إليه الأمس وما بلغ الروم من ر. . 	
والخديعة ، وقل و استرجع وامتلات نفسه هما ، ول لم ينكص عل 	
عقبيه وأصر على أن يبر وسمه ذاك؛ فشد الحشود وكتب السكتائ 	
حر وف 	وجمع الأزواد وأعد العتاد ، وسير ذلك كله إلى مسلة فى ال 	
ابرية ... 	
االعر ضررا باغا، ي الي را 	وكان الوع والبرد قد أض 	
أمراء) من ودق الشر ر عشب الر بةودراب البحر ، رلرلا أن تراب 	
الأرض لا يستساغ لسفو ه سفمالير دو االجو ع عن ا نعسهم و يذسأو ابهآجالهرا 	
وكأ ما محذت هذه الخسة عزمة مسلمة ، فصاير ورابط مقاوما كل 	
الهل ، فل يفك الحصار عن 	ما يكتنفه ويكتنف أحاه من أ 	
المدينة أو يتخل عما اعزم ا 	
وكأن أصحابه ء وتون كل يوم ممات ، صرع الجوع والبرد منهم 	
مر من صرع السيوف والسهام والتار الرومية، ولكن مسلمة 	
٢٨ 	
