أهذا وو الكان الطبيهى الذى يصح أن أجد 	اليدى ديدمو ند ـ 	
فيه زوجة ابف ! 	
ولير - اهر اته 	
لاخيك رجنالدج 	هل انت مستعدة أن تستمم 	الليدى ديدم و ند ـ 	
ع 	
كار ب لقد فملت 	
لك شهور ديى على الإطلاق 	ألي 	الليدى د دمو ند . 	
كار ـ يلا ، إذا كان الدين أن نعيش كا عشنا 	
الليدىدبدهو ند - ان هذا فظ. - هذه الحالة النفسمة - حقءقة 	
( كمار تضحك ضحكا رقيقة كافعات فالفصل الاول . وك" ما 	
ردت هذه الضحك: الحياة الى السر شارس بعد أن كان واها مذهولا 	
وهو يصغى إلى المناقشة 	
السبر شارس - استحلفك أن لا تضحى هذه الضحي . 	
( كلير تسكف ) 	
الليدى ديدمو ند - ( باتفعال ) أناشدك الق المجرد يا كلر ! 	
كلر ـ الحق ? مهما يكن الق ظن حياننا ليست حقا ، ( تضيع 	
يدها على قلبها ) افي أحلف أمام الله اى حاولت واوات ، أقم 	
الله أى لو ظننت انه مكن ان نتحاب هرة أخرى ولو حبا ضئي لا 	
أه إحد 	- - «س أمام الله أى لا أر اد أن أجرج ن 	اريجه 	
الليدى ديدمو ند واكنك تجردين كل نفس ـ آوى عالة . 	
كلير ـ ( وقد فقدت توازها وسكو ها ) ألا ترون الى أماهد 	
بكل مافى من قوة أن لاأدفن حية ـ ان لاأخزق شيئا فث يثا - انظروا 	
وف إلى الابد 	الى - لست فمعا بل لمما ودما . وانته تر يدون أن تسج: 	
- جسا و نفسا 	
السير سارس - والله لست أدري ! 	
الليدى د دم و ند - ( لاليس ) إذا كانت قد بقيت لك ذرة من 	
الكرامة اسيدى ازك تدرك أن عارك على كل عال أن تدرع ابنى يكلم 	
زوجته ( تشير إلى شارس ) سذذتظر ت . 	
٣٩- 	
