يدخل اربو من الممر وذهب إلى الحوان ومعه سلة فا كة فيضهها 	
جز وينظر ـ ( م يعود إلى كلير ) 	و يذهب إلى المامدة التى وراء الا 	
ادو مدام مدام؛ 	
تنمسا مم يامح جأة الزجاجة الصغيرة أيشمها ) يإالهى 	نصسى إلى ، 	
( عرج الذين وراء احاجز ملى صوته الغر يب وم أر بعة و ينظرون 	
ويمول الاسمر و هالو ا هل أغمى عليها ?» أيمد أرنو يده بالزماحة 	
الي» ) 	
الاورد الفاتر ( يتناول الزجاجة ويشهما ) وحق الله ? 	
( تنحنى المرأة معلى كلير وترفع يديها يجرى أرنو إلى التليفون 	
ودككم ) 	
ارنو -- المدر - إسرعة ( يلتفت فيرى الشاب عاثدا ) لقد فرت ! 	
لقد ماتت ! 	
اللورد الفاتر ( اشاب المذهول ) ماهذا أمى صديقتك م 	
الشاب يا المى ! لقد نت سيدة ! هذا كل ما أعرف عما : 	
ة 	، اللمورد 	
( ديكوذ الرجلان. الا سمر و الاشقر قد تسللا من الغرفة - 	
ين يدون فىااغرفة الاخرى صوت إمنى 	ويصل من ناحية الماءة الذ 	
انشودة «لقد ذهبت » وصوت المزمار تغى علسه أنشودة و اليوم 	
،وت غزال » وختامها خافت هادء انه روح نم عد مم ر ق الا نغام 	
فىضجة الغك . وقدغطى ااشاب وجه كنيه ـ وراح اررو رم 	
أما اللورد فوقف محدق واحدى الازاهير 	الم لميب علىصدره حرارة - 	
لوى ها أصابهه وتقبل المرأة جبين كلير ) 	
اسدل الستار 	
٨ 	
