نم و ن س من الضرورى أن تقول 	اللادى دده و ند 	
كذك اتهم ؟ 	
) تماما اسود و يرج 	بينتر ( باشم بزاز ولكن بأدب - 	
السير شارس أقسم ان هذا الفى مل أن هناك شيئا 	
كن حذرا ياشارس 	اللادى ددهو أد - 	
طبها 	السير شارس 	
ا ف اهاج 	مه 	اللادى ديدمو ند سأقتصر ءل القول بأسما- ، 	
وازنا لن نختظرها فى اوبة البردج 	
السير شارس وممغيا أه حادث ذك الرجل 	
( بينتر يعود مهلنا و اسكرتن هنتنجدون » - السير شارس والادى 	
د دم و ند لمتفتان اليه وقد تنفسا الم عداء ) 	
الليدى د دمو ند آه ! انداق أيار جنالد؟ 	
هنت:جدون (وهو ضابط طوبل وط فى اامـ لاين من مره ) 	
كرف أنت يإسيدى ؟ ماذا أصات هذا الربول ؟ 	كف حالك ? 	
- ماذا ؟ 	السير شارس 	
هنتنجدون كنت داخلا الى غرفة الامدة لأرى السيجار فقال 	
لى : لا تدخل ه:ا ياسيدى . ان سيدى فى الغرفة واسكن :علباى أن 	
أقول انه ليس هنا 	
اقد كنت أمل أن هذا الرجل . . 	السير شارس س 	
الليدى ديده و ند سـ الواقع يارجنالد أن كليى ف اهارج وأن 	
جورج ف انتظارها. وهن الميم جدا أن لا يعرف الناس ..٠ 	
طبيهى 	هنتنجور 	
( تدانون كا أعل الناس عادة للكلام فى مصائب أعضاء اسمر تمهم ) 	
ان المسألة تدخل فى دور الحطورة بارجنالد ، 	اامدى ديدمو ند 	
ولاأدرى ماذا سيكون مصيرها فهل تظن أن القسيس مكنه والدك أن 	
يكاكليم » 	
هنتمجدون - أظن ان والدى ليس في عالة صحية تسهح بذلك ، 	
أه عزن جدا امل هذه الوادث وخموصا ذا يتعلق بكلير 	
١١- 	
