ل عليه ، مم راها فتتشدد و تمشى إلى كرسيه ويجلس عليه . 	هسهم ة 	
غيم أن خلع قبعته ومعطفه ) 	
كلير - الر بدة ؟ ههه ؟ يحسن أن خبرف . 	
ا هناك ما أخبرك به يإفتاى 	ماليس ـ س 	
(س الرقة من أبرات ص وته فتدنو منه وتركع إلىما: . ر 	
ه 	مع مالاى . 	
كفير - اذن ستقد علك فيها أيضا؟ ( ماايس يحدق فى وجهما ) 	
الى أعرف . لاتسلى كيف ؟ 	
لاكلاب المنافقة ! 	ما لي 	
كلير ـ ( بصوت خفيض جدا ) ان هناك أعمالا أخرى مكن 	
الحصول عليها أليس كذلك ? 	
ماللاى - أوه كنية جسدا . لبس عل إلا اذ أشرج دأصمع 	
« ما ليس مؤ ان خائب . وصحف زيه جدا. حر الفكر زان . 	
واس » واذا بالا عال تتساقط عل رأمى 	
كلير ـ ( سدوء ) هل محمى باكنت ؟ ( ماليس يحماق فى وجها ) 	
ألست فى نظرك اكتر من امأة جميلة ? 	
ماليس ـ ليس هدا بوقت التفكير وارخا، الاجنحة . فأقظى 	
له -ك واعضى للجفاج 	
كير ـ بعم 	
اننا لانزوى ان بدعمم يطحنو ننا. اليس كذلك ? 	ما لي 	
( عك خدها فى رأسه الذى لا زال مسندا الى كتنها) اليداة عل 	
- وما حين 	عث وة العدو ، مم يدرك الطف علها 	ذمه 	
يفيص مهن رم:ه فيأذن انا الح فى ان نأ كل ونشرب ونقنوس مر 	
(ام 	أخري ( وبدى اشرارة ماخص فمها مقته ونقمته حس. 	
ك 	وبعته و يرص) هده آخر ماستطيهون أن نالوها م. 	
٦ 	
