ب 	كلير لا ظثدة من الو - ط . لقد يزات الى الميدان فتم ، 	
وفيق ( تشرب وتضع اد lt بابتسام) خضت البحر ، العميق 	فمه الم 	
(ترفعاغيها الى ما فوق وجها الباسه) يهبط الانسـان وربط حى 	
لا يبق إلا رأسه ، م يهبط وهبط .. و ينتهى الامس ، هل أنت الا ذ 	
نادم على انك امتنى؟ 	
الشات - لا وحق الله ، وقد لايكونهذا من المبل ولكى است نادما 	
كلير ـ لنحمد الله عل اتجـال ، وأرجو ان أهوت جميلة اتظن 	
اف سأوفق فى هذا ااطر دق 	
الشات - اممى ٠ لا تةكاءى هكذا 	
- افى أريد ان أعرف فقل لى 	
الشاب اذن. نهم ستوفقين 	
e ٠ وهؤلاء النسوة الاواى يتمشين فى الشوارع 	كلير - هـ ذا د 	
لم. بميلات مثلى ؟ أليس كذلك ؟ ان 	تمنين ان او باداننى بهيو عن - ن 	
فل تظن اى سأضطر ان 	علن أن قطعن الطريق جيئة وذهابا . 	
أفول مثلمن . 	
أشاب سم بالوض ويفع فه عل ذراءا ) 	
الفاي - اظن انك مهتاجة أكر مما يجب . انك تبددين . ألا 	
تا كاين خو ختك ؟ (ز رأسا تنها ) كاما.أو خذى يثا آخر اذن.. 	
كلر ـ كلا واشكرك (وتكون قد هدأت جدا ) 	
- حسن ، اذن . ما رأيك ؟ ان الجو حار جد هنا أليس 	الشا 	
كذلك أولا يكون خيما ان نركب سيارة فى الهواء الطلق ؟ 	
قعل نقوم ? 	
كلر نه 	
( يلتفت الشاب ليرى الادم ولك: لايكون فى الغرفة ، فينهض ) 	
٧٨-٠ 	
