ر اارسى رد. وتهثى فى الغرفة ) 	( ما أيس ـ زوع نفسه م . 	
ي ب بوويص بعد ان قاله 	كاير - هل تعرف اكنت لماذا لا طا! 	
بوم يذ ؟ ( تنظر اليه أة ) اايس صجيجا انه لا بطالب 	ما قال ه:-ا . 	
و ي ، ، 	
- كلا . ليس بمحدرح 	ما لي 	
ولكنك قات لى هذا تهسك ? 	كفي - 	
ـ كنت أ كذب 	
- لاـاذا 	كلير 	
( ز تفيه ) لا ؤلدة الان من المكذ فستهرفين كل 	مالين ـ 	
، غدا . 	
كلير ء ب يطب ? 	
ما ليس ـ بألفى جنيه ( عقت ) سيوب فوائدها للاك ( يضحك ) ياها 	
من مهارة، بضرة واحدة سلاك عدوه ولأتقم لشرفه وبضيف الىى 	
المه حلية المكرم والمروءة 	
٢لى ـ وهل ستضطر الى دفع الهو يض ؟ 	
- - ان احجارة لايقطر ممها الدم 	ماام 	
كلير - ألا تستطيع أن تقترض 	
الصدد ول ى ملى ما كفى اعهاريف 	مال ب ليس ف دموى 	
الدءوى . 	
كلير ـ هل سيعلنون افلاسك إذن ( يهز رأسه موافقا ) و لكن 	
هل مدى هذا انك ستفقد دخلا (مالدس يضجك) ماهو دخلاك يا زت 	
(ز م لصهت) افى أءرف اناب تتناول مامة ج:.ه و سين و ااسنة من 	
جر يدة «واتشةاير فاذا هناك غير ذلك؟ 	
ايت 	الجس - رت أر بوين جنبها من 	
fايم - وماذا أنضا ج قل لىى 	
-٨ 	
