أن ذلك الرجل ليس هنا . ( بلق جرس الباب ) اظنه هو 	
السير شارس ـ ماذا نقول ? 	
لن ننةظرها 	"ران فى الهاج والزا 	هنا:جدود - أؤول اهما يمهم 	
للعبة الرذج 	
سبر سارس - حسه . 	
رسن يد خل ما وس . 	( بغتح الباب ويهلن بيذتر : المستر كنت ماار 	
وهو رجل طو ل فى الهامسة واءلارين من عمره ووجيه حا اممارف 	
غر منةظمها وعليه أمارات الهج ، وعيناه ا ن فى انساذمسا ارا ، 	
وشره الكهف عر مسرى وثهابه أيست جديدة جدا ) 	
الايدى ددموبد - كمف حالك؟ ان اينن وزوجته آسسهان دا 	
وسيحضران حالا 	
( وينحى ماايس بابتسامة غرسه. 	
السير شارس ( «عما ) كيف حالاك بإسهد م 	
هنتزجدون ـ لقد تقا بلنا ذيا أظن 	
. س تلاى النظرة الياسم ة التى كا"ا محسذد إن ااى 	( يذظر إلى ما لد 	
علمه ، تام. عيذا مالدس ) 	
الليدى دبدمو ند ان كار لاشك ستتأر جدا واكنك أمرف 	
تلاث الدعوات الى . . 	أذ دء 	
والوس - عفو السماعة 	
السير شارس ـ هل تلب البردج اسيد 	
بر سف 	
الدير شارس - لا أنازك اد؟ ؟ إذن عن مضطرون أن ننتظرما 	
اللمدى ددمو بد ـ اقد نسدت الست:.ا مسر ماليس 	
«ى 	هذا ض 	ما ليسى 	
نه دده 	الليدى ددمو ند ١" l 	
سبر سارس لا تفمدك إشىء . هه؟ 	
أأر س- نقيدك من رأسك فقط 	
١٣- 	
