الإس - اشتغل بقدر ما أءطاى الله من قوة 	
كلير ـ ( خالس نظرة أخرى اليه ) هل عندك ورق تريد أن تنقله 	
ى حلية فى 	، ولا تزال 	على الالة الكاتبة ؟ اى أستطيع أن اتهلم 	
مقدورى ان اما وانتفع شهها - اى الانواع خير م 	
اقد كنت عندى تأمة بأبواعها لا اعلم أين مى 	مااده 	
- رج ى ض كلير 	( يذهب إلى الغرفة الداخلمةـ ولا يكاد - 	
" رءتقدة ف، ما ، مممف ماتظرة 	وكفاها عل خديا كا ا - النا 	
بالقامة ) 	و اها متصاةءتان ـ دود مالدم 	
الـ ن - هل تستطيعين الـحتابة فى بيتك ) 	
كاير ـ انا مفهطرة الى البحث من غرفة أخرى ، لابد من الانتقال 	
• ت قفازها إنعالا بايدا ع أشياما ) لقد 	لأ كون آمنة (رع ب 	
حملت أث.امى الى معطة ث بر ج كروس . حقيبة صفيرة وأخري كبرة 	
«مم تقول له وعلى وجهما دلاثل التهيؤ للاندفاع إلى مجازفة » 	
- أظنك لا تريدف الا د؟ 	
ماذا ? 	ما ليى ـ 	
كام ـ و بصوت يكاد راون كاهه س » لا نك إذازت لاتزال 	
ى ا-تى ذلك الا ن 	تر ال فى فا 	
م المضطرب » هل تعنين 	الي و «ناظرا بقوة إلى وجمها ١١ 	
ماتقولين ? هل تردين ؟ هل عبينن ? 	
كر - لقد كنت أفكر فيك كشرا و اسكن يجب أن تكون وامقا 	
احراسك انت ! 	من 	
( يعتضها و يقمل عيذيها المغمضتين ويقفان هكذا لحظة حتى سمها 	
صوت المفتاح فى قفل الباب ) 	
ماليس اما خادمة البيت اعطى هذا الارصال سأرسل من جىء 	
قامبك 	
«تطيهه وتناوله الايعال وتبده وتدهب فى سكون إلى الغرفة 	
