١٧ 	
وقد خيل إلى شهر يار ان طائفه ذاك قد أاء إليه حديثه هذا 	اد 	
الطو يل فى وقت يمدله طولا كا تهد الناس أن يتحدث لعضهم 	
: - به إلا لحظة 	إلى بعض ، ولكنه لو اطلع لرأى ان طائفه ذاك لم ل 	اد 	
الره حديثه فها جما: . والة ذلك أنه افاق 	وصيرة جدا أإم 	
، - 	
لكنه كان كأما عاد إلى النوم 	اها هرة دمر. 	فأنكر هذا الطا". 	
هذا الحد "كله من طائفه فأفاق متكرا لى 	وعاد النوم الا مع 	ان 	
،٥ وصيرة اقصر من ان 	إنمااغ. إغفا "4 - 	٠» 	ب . يرى انه 	
تطول لهذا الحديث . فالما الح عليه الطائف بحديثه ير إلا ان 	ما 	
ر ويعبر الرويا و ختبر صدق هذا الح . فسمى إلى 	يجب الاء 	له 	
، وأمرا حراسه 	غرفة شهر زاد فرأى فيها ما راى وسمع فيها ما سمع 	الا 	
س نفسه إلى الزوم واطمان إلى 	، نم لم 	أ ا الملكة ما أ 	
ور 	ورس 	
حصة الناعة ، 	شرر زاد بيدها الر. 	صدره الوتير حتى استلته منه 	
وصوتا العذب ابلجيل ، ووجهها المشرق الوضاء ، ونظرا تلاك 	
الغامضة اشد الهموص ، 	
ى بر بار مواره هادنا مطمين النفس رصى 	ومع دلاك فقد أنة- 	
متصرفا ى أموره ا تهود ان يفمل قبل أن يعتر به هذا 	الما! 	
س ،و يتعر انه فقد شدا ولايجد 	س حونا ولاا فاوا لا 	القلق ، لا يع 	
