٤ ٩ 	
وكيف تر يدلى ملى أن أصف لك ما لا يوصف ، أو ان 	
أصور لك ما لا سبيل إلى تصوره . لقد انعقد لسان شهر يار 	
لانه احس وتجزعن لصو ير حسه ، والعقد لسان شهرزاد لار، 	
تدمرت ويجزت عن نصو ير شعورها . ومع داك فما أكتر ما قال 	
الملاك مينيه لشهرزاد! وما أكثر ما قالت شهرزاد مينيها للهلاك ! . 	
ل 	و يغيل إلى ان أو اتيح لنب ان يترجم بعض ما كانت 	
الة 	تقوله هذه الاءين لزم ان شهرزاد كانت بقول الكلاللي : أترى إلى 	
هذا الته ! لقد وعدتك به ، وكنت أظن أى سأ كون أقدر 	
بهور 	
منك عل احتاله ، وأى سأكون منك مؤن الترجمان يدللاك 	
عليه و عتعك به و يصف لك دقائقه ، ولكى مع ذاك مأ اطع 	
ر يت إلى مثل ما!) - 	امم 	ان اثبت اةوته ولا لرقته ولا لسج ه ، فا 	
انت المه م . 	
كال - 	. ن العجز والاستسلا 	
وكا ن شر يار يقول لشهرزاد : :ـ ! اقد قهر هذا النه قوتك 	
: 	
الثائرة ونفساك الجامحة ، كا قهر قولى الممهاسكة ونفسبى المستسامة .. 	
ظليلك 	واقد سوى ييننا فى هذا الضعف الحاو وهده الراحة الممتمة او هذا 	
هرا اس 	حيب ، ورئمى إلى . ١٠: - 	المتاع المرج : لقدأبزلك إلى "أا 	
أ 	وا أراك الان رأى الدين ء وأنا اعرفك الان حقى العرنة ، و 	
ببطلن. 	
