- 	
نفيله 	
عل أن غداء عذ با يبلغ ستممه كا نه ترتيل المالاشكة - لو أن 	عليه 	
لناس أن يسهموا ترتيل الملانكة- فلا يكاد مسح سممه عتى 	
، ل 	
نتض إلى نفسه الشاعرة فيه كفاها ففى أناة و يستلها من النوم ى 	ف 	
طن، ا كان أبو واس بستل من المن ررء فى أطف ، 	ذال 	
. ف من بومه ، ولسكنه بمسك نفسه فى هذا 	و إذا الملك 	
ده 	
السكون المى كان فيه قبل أن يخرج من النوم كا نه كان بر يد 	
ان إسابق حلإوة هدا الغز ء . 	
مذه 	
حين استيقظ ، انه غااط نفسه 	وكان يظن ، ا يظن الحالم 	
وم ، وأن اليقظة ذاهبة بلذة احلامه لا محالة ، ولكنه 	ويغااط الم 	مسه 	
دللاك يسم هدا الغناء العدت و محس مووهه من ولبه و ندبين 	ف 	
الاموات التى بحمله والالفاظ التى يحو به . وكا ن هذه الاصوات 	عه 	
ت اصدر عن هذه الامواج الصغيرة التى كانت تصطفق مى 	
عوه ونداعب زورقه هذا الهر دب ، وكا ن هذه الامواح كانت 	
و . وما ذبلا المذ قائلة فى لغة فارسية رهيقه حاوة : 	ناء ه ا 	
" بالدوم ، 	لمم) 	باليقظة كاا - 	«ق أيها الإنسان السميد ل 	
