تلك الأربهة التي كان قد وقف نظره عليها . فأول مانظر 	
الى الماء فرأى أنه اذا خلى وما نتضيه صورته ، فظبر منه 	
، طاب النزول ( إلى أسفل) فاذا سخ 	أرن مسوس د 	
(أولا ألإما بالنار وإما بجرارة الشمس ، زال عنه البرد 	
مسحان 	اولا ويق فيه طلس النزول ، فا ذاافرط عله بالة 	
زالءده طلب النزول إلى أمذل . وصار يطلب الصمود 	
إلى فوق ٠ فزال عنه بالجملة الرصفان اللذان كانا أبدا يصدران 	
عنه وعن صورته، ولم يمرف من صورته أكتر من صدور 	
هذين الفعلين عنها ٠ فلا زال هذان الفعلان إذن بطل 	
كم الصورة ، فزالت الصورة الماثية عن ذلك الح عند 	
ما ظهرت منه أفمال من شانها أن تصدر عن صورة أخرى ء 	
و حدثت له صورة أخرى، بعد أن لمتكن ، وصدر عنه .ها 	
أفعال لم وسكنمن شأمها أن تصدرعنه وهو بصورته الاولى. 	
من محدت . 	فما بالضرورة أن كل حادث لا بد له 	
فارتسم في نفسه بيذا الاعمار فاعل أصورة ارتساما 	
عل العموم دون تفصيل . 	
١) 	
مم إنه تتبع الصور التي كان قدعلمها قبل ذلك ، 	
من 	صورة صورة ، فراى أنها كاها حادثة ء وأنها لا بد لها 	
(١) في مط : عاينها . 	
