عنها ء بل كان ابثداو هما ء ما ، وكدلك المالكه ، مهلول 	
وخلوق لهذا الفاعل بغير زمان ( إنماامره إذا أراد شيئ أن 	
و و (١) 	
يمول له ك فيكون . 	
ع وجودات فمله لصفحا من قبل 	فلا رأى أن م. ال 	
(٢) 	
وس 	أ عل طري الاء مار ، في قدرة فاعا ١ ٤ الته 	اصفح 	ذا 	
من غرين ص:وته، واطيف حكته ء ودقيق علمه ، فتبين له 	
وجودة، فضلا عن أ كثرها ء من ا ثار 	ي أقل الا شياء الأ 	
، وعقف 	الحكة، وبدائع اأص:هة ، ما قضى منه كل المحى 	
عنده أن ذلك لا يصدر إلا عن فاعل مختار في غاية الكال 	
• 	c' 	
يمز عنه مثقال ذرة ي 	( وفوف الال « لا 	
ر من ذلك ولا 	الموات ولا في الارض ولا أصم 	
3"» 	
تم تأمل في جميم أصناف الحيوان ، كيف «أعط 	
« ٤) 	
" لاتماله ، فلولا أنه 	كل شه خاقه ؛ " هـدا 	
() 	
له يذ وجوه 	هداه لاستمال نك الا عضاء التى خلقت 	
ع اطبوات ، و كانت كالا 	• لم اندة 	ع المهصودة ب 	المشاة 	
(٢) في مط : من 	، الا ة ٨٢ 	، سود 	(١) قران كر. ة! 	
(٤) 	أ ٠ الا بة م 	(٣) فران أرم : سورة سب 	ذي فبل 	
(٥) في ط : خلى 	ورة طه ٢ الا دة ٠ ٥ 	قرا ن كرم . 	
