عنه ال ذلك 	لكه لما لم، كنه ذلك » ورأى انه إن امت: 	
الى فساد جسمه ، فيكون ذلث اعتراضا عل فاءاه أشد من 	
ر • ون 	الا ول ، إذه أشرف من تلاث الا شياء الا اـ ك 	
ف ادها سدما لقائه . فاسقسول أيسر الفمررين ، وزساميح في 	
اذا 	أخف الاعتراضين ، وراى أن ياخذ من هذه الا حنا 	
عدمت اها تدمر له بالقدر الذي يتبين له بمد هذا ٠ فاءا ان 	
حمدمد ان دمتدت وتحر م 	له 	مح ده و.دمة 	كانت كأب 	
رر على أمل الفاعل وذلك 	ما لم كن في أخذه كبي اعترا. 	
مل طوم الهوا ك التي قد تناهت في الطي ، وصاح ما فيها 	
من البزر لتوليد الذل عل شرط التحفظ بذلك البزر ، بان لا 	
واكل ولا يفسده ولا يلقيه في موضع لا يصلح للنبات ، مثل 	
ر١ ) 	
والسخة ونحوهما ، فان تعذر عليه وجود 	الصهاه 	
لا م الغاذي ، كالتفاح والكثرى 	مثل هذه الثمرات دا ح 	
والا جاص ونحوهاء كان له عند ذلاك ( أن واخذ) إما من 	
. لمر 	نفس البزر ء "كا . 	إ. لا يغذو منها الا 	الثمرات ى 	
والقسطلء وإما من البقول التي لم تصل بعد ) حد كالها . 	
والشرط عليه في هذين ان يقصد اكثرها وجودا وأقواها 	
صفاة : الجر الصلد الضخم لا ينبت ، 	(١١١ " 	
(٢) السبخة : أرفن ذات نز وماح ٠ 	
لاه) 	
