ويتقن مخماف الصناءات ء وإسيطر عل الطبيعة م بدرك قدرة الا له 	
أ. : مكن يري إلى 	فيا ناره ٠ ولكن ييب ان لا نفسى ؛ د دي مو 	
يل ." الطبيعة ل الحياة الاجتاعيةء عدا أن بطل روايته روبثصون 	
لم يولد وحيدا فيهذه الزيرة » بل قد خرج من لاده وأهله كشات 	
فر ي سفينة وحده ، فحطمت ازوبعة سفينته » ووقع اسيدا في ادي 	
قرصان البحر م فر حتى وصل الى الزيرة الخالية ٠ وقد استطاع أن 	
ين قظان 	• بفضل ما كان عنده من المعلومات ، خلاقا ل 	
الذي ولد من غير أب ولا أم ولم يستفد من شمل البشر قبله شيما ٠ 	
وهناك فرق كبير أيضا «ين تطور حياة تل من البطلين من 	
الناحية النفسية : فا نه بهنا اقتصر تطور روبنصون المقل على بعض 	
الملاحظات الجزئية في نظام الـكون نرى ي بن بقطان يقط 	
جمهع الا دوار والمراحل التي مر منها العقل البشري عامة للوصل إلى 	
أمى درجات المعرفة ٠ فا ن الغاية الفلسفية عند دي فو لمتأت الاءر ضاء 	
بمنا ي الأساس عند اين الطفيل . 	
و غتاز قصة ابن الطفيل عن قصة دي فو من الناحية الفلسفية ء 	
ة بالقرب من 	همة الس م 	فإنها تتاز أيضا من غيرها من القصص الفا . 	
الحقيقة الواقعة ، وبالوصف الطبيه ) والتفصيلات الدقيقة عن الحياة 	
لة العبارة» وحسن الأرنب ؟ 	المملية؟ عدا عن رشاقة الأساوب ، وسرو 	
وي بهذه المزايا تهتبر ء ولاشك ء فيقدمة الا ثار المربية التي ئسمحى 	
احاود في تارخ الفكر البشري . 	
