ط الا انا: 	رد يو 	والدروج ، فتاقى له بذلك ما أمله 	
وانما تفنن في هذه 	عله الحيلة في أخذها ، 	التى ههس 	
وشونه في 	اله بالنثرج 	وور سمخ 	مور كاها في 	الا 	
عل خصالص أعضاء الحيوان ء وبماذا تختلف ، وذلك 	وقو فه 	
في المدة التي حددنا منتهاها باحد وعشرين عاما . 	
ممرف:ه هال الكوه والهار 	
(١) 	
، فمصه ج 	ثمم إنه بعد ذلك أغذ في ماخذ أخر 	
وى ومساد : من الموانات عل 	٣) 	الا جسام التي في عالم ألك ٠ " 0. 	
اختلاف أنو امهاء والنبات » والمعادن ، وأصناف الجارة 	
ااثا والبرد ، والدخان ( والجليد) 	والتراب والألا واليد د د ج 	
"ف أى لها أوصافا كثيرة وأفعالا ضتلفة، 	والابيب وا ر. ر 	
، أ:ـ النفظ ف ذلاك " والتشبث ، 	وحر كأت متفقة و.تضاده.وم ر. 	
فرأى أنها لتفق ببعض الصفات وتختلف ببعض ، وانا 	
ي تعق بسا واحدة ، ومن الجية التى تختلف 	من الجية ااء . 	
ر غصانص 	ظ 	فها متفايرة ومتكثرة . فكن تارة ي: 	
، وسكير ء ده كبره 	يممرد به بمضها عن بومر 	الا شياء وما ٠ 	
ترج عن الحصر ، وينتشر له الوجوداننشارا لا يضبط . 	
() الـكون : خروج الشي من 	(1) في ط : ماخذ من ااتظر 	
(٣) اافساد: خرو ج الشي من الوجود إلى العد ٠ 	العدم الى الوجود 	
١٠٧ 	
