(١) i 	
الوجود ، وودكان 	د. بالوجود الواج 	ما دظنه انهه 	
انه 	ذ ته ااقد شه ت ، قط ادلاث عا 	
، ااشد بالا ام الاوية 	هو الدوان المهتدل الروح 	
(كلما ) / ونييت له أنه نوع مباين لسائر (أنواع ) 	
لغاية أخرى ، واعد لا 	الحيوان ، وأنه إنا غاى 	
تعد له ث من الولي ( يوان ء وكغ ه 	عهظيم ، م. 	
وهو الجه مافي 	د٠ا ده 	شرفا أن يكون اغس .ر. 	
عالم الكون 	ه الدساوية الفارحة عن 	أثبه الاشياء بالوا ر 	
والفساد » المنزهة عن حوادت الهص والاستحالة والتفير ! 	
الذي ه عرف الموجود 	و الشى 	وأما اشرف جرايه ، 	
المسارف ، أم ربلإفي 	أجب الوجود ، وهذا الشىء 	
ل و ) لا يلحقه الفساد ، ولا بوصف 	العى ( لا يسة . 	
روصف ه الاجسام ، ولا يدرك بشى، من 	بشىء مما - 	
و وتوصل إلى رفته نا لة 	"ولايتخل ، لا 	الحوا 	
او امارف والمهروف، 	واه ، إل يتوصل إله به ؟ : 	
مماكي 	والمملوم ، والملم ، لا فساين في ، 	والاءرفة ٢ وهو العالم 	
ال من صفات الا حا 	، اذالتان والا عصت 	من ذ 	
لا لاسن سه! 	ولو احق ، ولا جه هزالاف ولا صفه جم و 	
(١) في ط : ما يدت عامه . 	
٥ 	
