، اكنه م يأت له بال 	و جسه 	لأجسم من 	
لا يكون فبه معنى زامد 	ك 	و جود جس بهد ه الصفة وحدها ء ء 	
عل الا م تداد المذ كور ودكون بالجملة خلوامن سامر الصور . 	
تفكر فى هذا الامتداد إلى الاقطار الثلانة هل هو 	
نه ، وليس م ءمنى اخر او ليس الامر) 	ممى لأ م .. 	
ي اخر ، هو الذي 	كذ لك ؟ فرأى أن وراء هذا الامتداد مما 	
يوجد فمه هذا الا مت د اد ء وأن الامتداد وحده لامكن أن 	
انفه ، ا أن ذلك الشيء ( الممتد) ء لاهكن أن يقوم 	
يعوم . 	
هذه الأجسام 	انفسه دون امتداد ٠ واعتر ذاك ببعض 	
، كالطين مثلا ، ؤ أى أنه إذا هل 	الحسودة ذوات الصور 	
سكل ما كالكرة مثلا ، كان له طول وعرض وعمن 	مه سه 	
معلى قدر ما . م إن تلاث الكرة بعنها لو أخذت وردت 	
، لتدل ذاث الطول وذ لك 	وست 	إلى شكل ما . أ . 	
المرض و ذللاك العمقء وصارت عل قدر اخر ، غير الذي ا نت 	
عله ، والطن واحد بعنه يددل ؟ غير انه لاند له من 	
طول وعرض و مق ملى اي قدر كان ، ولا مكن ان يمرى 	
له أ١٠م: عل حياله 	•قرباعله ، نبان ٣ 	نبا غير أنها (ه ، 	
واسكونه لا يعرى بالجملة عدها ء فمين له امر من 	
١٢١ 	
