رزل مه في الرعود، وفي من الكؤة( ـي حد ) بجيث 	
لا نتناهى إن جاز أن يقال لها كثيرة ، أو في كاها متحدة 	
إن جاز أن يقال لها واحدة ، ورأى لذاته ولتلاث الذوات 	
التي في رتبته من الحسن والما" وااللذة غير الكناهة ء ( مالا 	
ب إشر ) ، ولا 	عين رأت ولا أذن مممت ، ولا خطر عل فا 	
ر٣) 	٣) 	
إصفه الواصفون ، ولا يمةله إلا الواصلون المارفون 	
وشاهد ذواتا كثيرة مفارقة لمادة كا نهسا مرايا صدمة ، 	
(٤) 	
قدرات ايها الطبت ء ويي مع ذلك مستديرة للمرايا 	
س ، ومولية عما 	الصقيلة التى ارأسمت فيهسا صوره السم 	
بو جو هوا ء ورأى لهذه الدوات من القيح والتقص مام م ومط 	
وراها ف الام لا تنقضى ، وحرات لا تنهجى ؟ ود 	دباله ؟ 	
أياط بها سرادق المذا واحرهم ر حت، ولشرب 	--نا ال 	
مناشير بين الانزعاج والانجذاب ٠ وشاهد هنادوانا 	
لصءحل » وتشههد " تج ، فثد ي 	هذه المعذبه قادح م 	
(١) في ط:واحد (٢) الواصاون : راجم المةذء ص ١٣٤ ، 	
أث ده الرب لره ء 	(٣)المارف من 	
فسه - وقد عقد ابن سدا في كتات الا شارات 	الأحوال ملي 	ر 	
فصلا مها في مقامات المارد افترس اين طفيل مده فقرة ي ،سعل 	
(،) ران : اشتد 	هذا الكتاب • 	
