وهى 	
وتطلب العلو ، فغلب عل ظنه أنها من جملة الجواهر 	
السباوية التى كان يشاهدها . 	
الا شياء بان يلقيها فيها ؟ 	وكان يجتبر قو تها في ه 	
فيراها مستولة عله : إما بسرعة وإما بطء بحسب قوة 	
استعداد الجه الذي كان يلقيه للاحتراق او ضعفه . 	
و كان من جملة ما ألى فيها عل سبيل الاختبار لقوتها 	
ت الحرية -كان قد القاه المحر 	ثي من أصناف الحيوان 	
ر (٣) 	ر١) 	
الى ساحله .. فلا أنضجت ذلك الحيوان وسطع قتاره 	
ر شروته إليه ، فا كل منه شثا فاستطاه» فاعتاد 	. 	
بذللاث أ كل اللحم ، فصرف الحيلة في صيد البر والبعر ، 	
حى ماد في ذلك 	
وزادت محبته للنار ؟ إذ تاتى له بها من وجوه 	
له قبل ذلك ؛ فا 	أت 	الاغتذاء الطي مى 	
اثارها وقوة 	ها لا رأى من ن 	استد شفهه 	
وقم في نفسه أن الشىء الذي ارسل منقلى 	اقتدارها ، 	
(أمه) الظة التى أنشاته ، كان من جوهر هذا الموجود 	
أو من ثىء يانسه . وأ كد ذلك في فانه، ما كان بواه 	
من حرارة الحبوان طول مدة حياته ، وبرودته من بعد 	
(١) ط: اشتوى (٢) القتار : رائحة اللحم والشواء 	
