المحاورة ء قر"ر الذهاب إليها اوكثف الى أهلوا عن وجه 	في اطزرة 	
س ودعوتهم إلى الحق مدة فصيرة 	الحقيقة واكنه لم ببدأ في مخالطة النا 	
ى قق لديه ان مهورم بعيد عن فهم القيقة الخالصة ، ورأى 	
أنه قدأغطأ في ظنه بأن الناس كاهم ذوو فطر فايقة ، وأذهان 	
ثافبة » ونةوس حازمة ؟ لاه لم بكن بدري ما م عليه من البلادة 	
والنقص ، وسرء الأي وضمف المزمء وأنهم كالا نعام بل م أضل 	
سيلا! وتصفح طبقات الناس فرأى كل حزب بما لديهم فرحون ء قد 	
م..اثهم ، وتلكا في جمع حطام 	الخذوا اليهم هوام » ومعبود تد 	
م مهم الموعظة ، ولا تهمل فيهم 	وألمام التكاثر ؟ لات 	الدنيا ، 	
الكامة المرية فاية كل واحد منهم مصر عل مال يجممه ، أو 	
و سروة يقضيا ء او غمظ ششف ه او جاه يرزه ٤ او 	لذة بناها ، 	
أو يدافع عن رقبته ! عند ذلك 	ل من ألهال الشرع بتزين به ، 	
أدرك يي بن بقظان السدي في التحاء الرسل الى الرموز والأمثال 	
بأنه لاسبهل إلى الا صلاح 	لتقررب القيقة الى اذهان الجاهيد ؟ واقتد 	
زرته الاارة ٠ 	وقرر الرجوع مح ابسال الى 	
تهل بل قسب 	هذه قصة ي بن يقظان ٠ ولي ، ا مرى ، ز" 	
ر الأول الا كبر لرصف اطور ي بن 	قد خصص ابن الطفيل القده 	
يقظان الطره ٠ للى أنه من المستبعد أن كون ابن الطفيل قد قصد 	
الا ول با مكان وصول الكرد التوحد إلى ماوصل اليه حي 	من هذا القه م 	
دون مساعدة الجاعة بل اا غامه بي تمثيل امكن تطور الشرية 	
د الينا من 	دون حاجة الى وح ممزل ٠ وهذه الذكرة في ااى - و 	
