ولم يزل م ابن االطفيل بعالو حتى بلغ ذروة الهد في الة الأغم 	
المه ت ، وصحمه 	من حيازه فاتصل بالفي يعقوب يوسف ماح ر. 	
ا طمه الاص » ووزيره؟ وكآن ابو يعقوب يوسفعبدالمؤمن 	حفيه ر 	
(( رقوى حواشي اللسان ء حلو الأ لفالاء حسن الحديث ، طر المجالسة» 	
وأحفظهم لأيامها في الماهلية 	أعرف الناس كمف تكلمت اامر ، 	
والا سلام ٠ وكان يحفظ القرآن ااسكر مع بملة من الفقه ٠ م طءح 	
كت الاء 	إلى ءإ الحكة ، وبدأ من ذلك بعل الطب ء وجمع من 	
شتا كثيرا ٠ وكن ميله إلى الحكة والفاسفة أكير من ميله الى 	
كر «المرا كشي» أيضا أن أبا بعقوب 	وود د 	(١) 	الا دب وبقية العاوم.، 	
لأن ابن الطفيل حا عظيا ، وأنهكان يق في قصره أياما طويلة 	
من فير ان يخرج منه ٠ وهذا يدل عل مبزلة ابن الطفيل عند 	
اي بمقوب ' وأتره في سياسة خاناء عبد المؤمن . 	
ولا نشك أبدا في أن ابن الطفول قد لمب دورا عظبا في بلاط أي 	
دعقوب لا نه د حاز تقة الا مير عبد المؤمن٠وسم اسرة المهدي 	
٠، ا رأين كاتم أمرار لان اللا ير أي سميدء ومار وزيرا 	ق: 	
لا ى بعقوب. ولا غرو لا ن ملاح أجـاد الا مرا" ابها كان باطباء ، 	
، ويهددون إليهم 	لذللاك كانوا كثيرا ما عطفون عليهم ويقربوهم 	
اعظم أمور الدولة : وان من نتيحة هذه الصلة بين أفي هقون 	
وابن الطفيل انج هذا الأخير الى بلاط عبد المؤمن كثيرا من 	
العلاء ي كل فن ومن جموع الا ؤطار منهم حكه الأندلس أبو الو ليد 	
٩ 	( ٠) اى خلكان : ٢ 	
