« الممحى في تلخوص أخبار المغرب » \L عرفناعن نشأة ابن الطفيل الا 	
، واحاطته بالهلك والرياضيات والط 	القليل ٠ ل أن عامه الواسع 	
. ق وعبارنه الرفيقة ، كل ذلك «دل معلى أن 	واشعر ء وأساوبه السه 	
ابن الطفيل قد تعل علوم زمانه كلوا ء وناق ثقافة أد نيةكاءلة ٠ ومعن 	
امرف عن أساتذته المو شدتا حقوقيا ٠ نه ! ان لسان الدين بن 	لا 	
الطيب والمرا كشي وابن خاسكان يقولون انا : « إن ابن الطفيل قد 	
أب بكر المائغ 	قرأ العل عل جاعة من أهل الحكة ، منهم 	
لأمروف « بابن باجه » وغيره ٠ »D) الا ان ابن الطفيل نفسه بقول في 	
(٢) 	مخص 	كتاب ي بن وقظان عند السكلام عن ابن اجه انه لم ياء : 	
فبو إذن لم يقرا عليه واسكنه يعترف له بالكال ء ويقول عنه إنه « 	
ذهنا ء ولا أصح نظراء ولا أصدى 	ده 	يكن في حكء الأندا أ 	
ع -"أبو اذن قد إتب بابن باجه ، 	روية من أي بكر الصاء. 	
واخذ بكثير من اراثه - ك سترى - ولكن لم رقرا ليه : 	
ولم يمض عل ابن الطفيل إلا القليل حتى اشتهر وذاع صيته 	
٢٣ 	
« إنه درس الل يخ 	في غرناطة ؟ وقد قال الغزيري 	
غرناظة ٠ » وذ كر المرا كشي أنه شغل متصب امين الا سرار 	
لاو ولاة غرناطة م عين بعد ذلك كام أسرار للايد أبي 	
عيد أحد أولاد عبد المؤمن وحاك طنحة . 	
(٢) حي بن قظان : م - ٩٩ قال : «فهذا 	(١) اين خلكان L٩٢/٤ 	
o•9 هذاالجل ، ونحن لم نلق شخصه ١» ٠ 	عال ما وصل الينا ن لم 	
Mositi EscuriaIeusis Hispana - arabica ct BibIiotheca ,Casiri 	
ThofaiI Ben .rt. générale TabIe .ol. 2 1770 	
