او. فهي اذن 	اوكل مالا ينفك عن هذه الصفة ، 	
ي كلا أجسام ٠ م تفكر هل ي ثدة إلى غير نهاية ء 	
وذاهبة ابدا فى الطول والمرض والممق إلى غير نهاية ، أو 	
تي متناهة محدودة بجدود تنقط عندها ، ولا مسكن أن 	
يكون و راءها ثبءمن الا متداد؟ فتحير في ذ لاث بمض حيرة : 	
انه قوة نظره"" ، وذ اء خاطره ، رأى ان جمبا لا نهاية 	
باطل ، وثي، لامكن ، و ممى لايهةل ! ولقوى 	ه أمر 	
له بهنه ودهن نفسه 	هذا الكم عنده عجب كثيرة سنحت 	
وذلك أنه قال: أما "" هذا الجسم (السياوي فبو ) ممناه من 	
، ذا لا أشك 	، ي بفي والناحية التي وقع عليها حدى 	ادةالت تا 	
فيه لانني أدره ببصري "" ' وأما الجية التى تقابل هذه 	
الة ، وفي التي يد اخلنى فيها الشك ء فا في أيضا أعا أنه 	
المحال أن تثد إلى غير نهاية ، لا في إن طيات ( أن ) 	من 	
حطين اتنن ، يبتدثان من هذه الجبة المتناهية ، ويران في 	
ب امتداد السم ء م مخيلت 	سمك الجسم إلى غير نهاية م 	
كبير من ناحية طرفه 	أن احدهذين احطن، قط. منه جزء 	
- (٤) 	
فه الذي كان فيه 	المتناي ،تأخذ مابق منه والبق ر 	
( ) في ط: ان (٣) في ط : بالمشاهدة 	(١) في ط : فطرةه 	
(٤) في ع: وطبق . 	
١٢٦ 	
