از الأطو طم 	
التى شورص م ( حي بن يقظان» 	
أسخة خطية في خزانة ا ل الطنطاوي بدمش من 	عترنا بل 	
ترتييا الوارد 	بموع يعوي عل أربع رسائل ، وبي ، عس 	
ضن الع . 	
المنقذ من الضلال « لاذزالي» 	
منى القاصد « الا نصاري » ٢ 	ارشاد القاصد الى 	
سدة ه )) 	صغيرة في الطر (( لا 	رمالة 	
ا ي 	
حي بن بقظان (( لا بن طفيل ) ٠ 	
هذا الهموع بخط المرحوم العلا مة ااشر ممد 	وقد 	
الطنطاوي الا زهري . 	
وقد فرع من أرخ حي بن قظان» عا ٠٥١٢٨٤ وجاء في 	
م كماب « مرقاة الزلق ء والشرب الا صؤء للا مام أليبـكر 	
ي رفي الله عنه » ولا يزال هذا الموع 	ابن طفيل الا ندا 	
فوظا في خزانة ا ل الط:طاوي بدمشق . 	
كل صفحة ٢٧ سطرا ء وعرض الكتوب من كل 	وقد ح ت 	
سطر ١١ سنتمتراء وطول الكموب في كل صفحة هو١٧ سنتعترا 	
وهذه المخطوطة صحيحة جدا ء والكاسخ ( رحمه الله ) نقل عن 	
ي ن قظان » بأمانة العالم واخلاصه. 	الا صل الذي نقل عنه ((- 	
ونرجح أنه نقل ي بن قظان عن مخطوط ء لا نبعض الاختلافات 	
