(١) 	
دعن مر 	وبعد بجث طو بل من كيفمة تاثير اشمة اكـء 	
الطينة الصالحة عل مر السدين والا ءام وامتزاج الوى وتعادها 	
وتكافثرا "" أى به ابن الطفيل شاهدا عل صحة ماذ كر من تجوين 	
ميعي ره يقص عايدا وجوا اخرء. أشاة تى 	التولد الذاي الط ،٠ 	
يقظان لا سكات من أنسكر جواز تولد الا أسان من غير أب ولا 	
م: فافترض أنه ولد في جزيرة مجاورة لزير:ه من أخت الملك التى 	
فاؤن من أخيها فقذفته في ال ء وجرفه المد الى الزيرة الثانية حدث 	
ملمه وألقمته حلـمتها واروه 	الاقطته ظمةانت فقدت طلإها وى: - 	
ضمة الوحشية 	«عنا أن ابن الطفيل قد الأمدس الأر 	لهبا سائغا ٠ وقد مر" 	
عن ابن سدنا الذي كان يرمز بالتغذية لبنها إلى افاضة الكال عليه 	
عا فقه . 	
ويجر ان لا نمر بوصف ابن الطفيل عن كيفية تون اءضاء 	
٣) 	
دقة هذا اا صف واستداده 	دون الاشارة الى 	الاأسان حميها 	
اليه من معرفة في التذرج و 	الى العلوم الطبيعية وما وصات 	
أطور الدين بالرحم ، 	
م يذمقل ابن الطفيل إلى وصف ثربية ااطفل وتعود الظ.مة له. ولا 	
أفالي اذا قلمنا ان وصفه هنا يذوق كل ما نعرفه في هذا الباب بالدقة 	
وشدة الملاحظة وسعة الاختبار : فوولم نترك شاردة ولا واردة الا أفقها 	
فشرح محا كاةالطل لأ صوات الحيوانات فى الاستصراخ والاستملاف 	
٤ 	
والاستدعاء والاستدفاع ٠وفي ذلك اشارة الى نشأة الافة الطبيعية 	
بن شظان س «ه 	ب) 	ي إن ظان م ٧٦ 	(١) - 	
ي ين يقطان صفحة ٨٨ 	() - 	صح ٨٤ 	٣١) عي بن قظا. 	
٤٧ 	
