قدر واحد من لمظ فيحال 	يضا من أنها نظرر لبصره عل 	
طلوعها و نو سطما وغرو بهاء وأنمها لو كانت راتها عل فير 	
شكل الكرة لكنت لا مالة في بمض الا وقات ، أقرب 	
نا في وقت ا خر ء ولو كانت كذلاث ، لسكنت 	اه هم 	إلى 	
مقادير ها وأعظامها تختلف عند بصره فيراها فى حال اله 	
أعظ مما يراها في حال العد ء ( لاختلاف أهادها عن 	
م زه حيثذ بخلافها عل الا ول) ٠ فظا لم يكن ثىء م 	
ذلاك ، بحقق عنده كروية الشكل . 	
، فبراها اخدة من 	القم 	وما زال نصة 	
كات الكواك السارة كذاك، 	المرب إلى الأشرف، وحر 	
حتى تبين له قدر كبير من عالم الهمة ء وظهر له أن ر 8ي 	
لا تكون إلا بافلاكاثه ة ، كلها مضعئة في فلك واحدء 	
هو أعلاها ، وهو الذي ك الكل من الإرق إلى الأقرب 	
ومعرفه داك 	كفة ادقاله ، 	ودمج 	في الوم واللية؟ ، 	
١) . 	
قب ولا يحتاج مه في غر ضنا 	، وهو «ييت فالك 	يطول 	
إلا للقدر الذي أوردناه . 	
مل أن الفلاك بعكه 	فلا انده إلى هذه المهرفة» ووقف 	
ل.. ض وأن 	ى واحد متم 4» 	وما يتوي عليه ، آ 	
(١) في ط : ٠بوث 	
دلا؟)) 	٢٩ 	
