المحاب المستبطن للأضلاع ، ووجد الرثة عل " ماوجده من 	
«ضو هو مطلوبه فحراول 	هذه الجية . غى بان ذلك ال 	
وشق شغافه » فسكد وامتكراه ما ، قدر عل 	هتك ججابه » 	
ذلك ، عد استفراع محروده 	
٢ من كل جهة ، فبظر هل 	فراه مصم.. 	القا 	
لمر فيه شرثا! فشد عله يده ، 	يرى فيه افة ظ هرة ? ف 	
فتبين له أن فيه جويفا ؟ فقال : « لعل مطلوبي الا قصى انما 	
هر في داخل هذا المضو ، وانا حتى الا ن لم أصل إليه » 	
٣) 	
فه جويفين اننين : أحدهما من اللة 	وثى عليه ، فالفى 	
، والا خر من الجهة اليسمرى،والذيمن الجهة الي-ى علو. 	اليمى 	
بعلق منعقد» والذي من الجية اليسرى خال لا شيء فيه. فقال: 	
«لن يمدو مطلى أن يكون مسكنه أحد هذين البيتين » 	
ثم قال : «أما هذا البيت الا يمن ؛ فلا أرى فيه غير هذا الد 	
النمقد : ولا شك انه لم ينعقد حتى" صار الجسد كله الى هذا 	
الال»» إذكأن قد شاهد أن الدماء (كأما ) ء متى مالت 	
إيك. هذا الأدماكسامر 	(وحرجن)»انعقدت وجمدت و 	
م موجود في سامر الا عضاء 	الدماء " وأنا أرى أن هذا الد 	
(١) فيط:كثل ()في ط: فرأى (٣) في ط: الا 	
إهد أن صار 	
٦ و 	
