واتفق في بعض الا حيان أن القدحت نار في أجة قاخ عل 	
زا ) 	سبل الهاكم 	
(٣) 	
فلا بصر بها رأى منظرا هاله ، وخلقا لميمتده ول 	
ا شبثا فشدا » 	يدنو ٣ 	١٠ ملما ؟ وما زال 	وووف إم 	
لا تعاق 	ا) ل الهائي ٢ ح 	فر أى ما لانار من الضوء الثاق و هم 	
إلا أتت عليه وأحالته الى نفسها ، خمله المج بها . 	لشى 	
ووا ر كس الله ( تعالى) فى طباعه من ا. راءة والقوة ء 	
فلما باشرها 	م د راد أن اخذ منها شيئ . 	عل ان يمد يده ال ٤١ 	
ما ١، فاهتدى إل أن 	٠ : 	حرفت يده فا لبط الق : 	
ل النار عل جميعه ، فاخذ اطرفه الدار 	رأخذ قبسا لم تستو 	
والنار في بارف الا خر ، فتاقى له ذلك ، وله الىءوضمه 	
(كان ) 	الفي كان وأوي إلبه - ركان قد غاد في 	
استحسنه للكنى قبل ذلك 	
ما زال د نلاث النار بالحشيش والط الزل ، 	
نها وكأن 	ويتهمدها ليلا ونهاراء استحسانا وتعجما م 	
يزيد أنده ا ليلا ء لا نها كانت تهوم (له ) عام اكءس 	
فى الض.ا" والدف، ؟ فمظم بها ورعه ، واعنقد انها أفضل 	
يه فوى 	و بدء يراها تترك الى 	الاشاءالتى لديه ٠ كا. VISI 	
(٢) في ط : بمهده 	الا جوف 	: القصت 	(١) القلخ 	
