ج بمرء 	ذلاك الموجود ( كل ) ساعة ، فساهو إلا أن إ: 	
و . 	مه ؟ او خرو 4aC•d ص ت ه 	موسوس ما من امه و ا- 	
الديوان ٠ أو يعترضه خيال من الخيالات ، او يناله ألم في 	
أحد أعضائه ء أو يصيبه اجوع أو اله طش او االبر داوا رء 	
ل» ، ويزول 	نل وكر 	أو يتا ج الى القيام لدة فضوله 	
شما كان فيه ، يتعذر ( عليه ) الرجو ع إلى ما كان عليه من 	
حال المشاهدة ، إلا مد جهد. وكأن يفاف أن لفاء منيته 	
الى الشقاء ( الدائم)، وأم 	و د : ي 	ة 	وهو في حال الاء ا 	
الحا 	
فممل ،نمفح 	فساءه حاله ذلك، وأعاه الدواء . 	
انوا ع الحيوانات كاها ء ونظر افعالها وما تدس فيه ، امله 	
(١) 	
ه ذاا! ح د ، وحه ت لسه 	ينظر في بعضها أنها ، ر" و.و 	
، فيتهل منها ما يكون سبي نحاته .فراها كلا إنما تسس 	و 	
في بحصيل غذائها ، ومقتفى شهواتها من الأطهوم والمتروب 	
والمنكو ح ء والاسثظلال والاستدفاء، وتجدافي ذلك . 	
ساه ما نح ف 	ونهارهاإلىحين اتهاوانةضاء مدتها، وإير . 	
لغيره في وقت من الا وقات ، 	عن هذا ال أي ، ولا يسى 	
دثر بذلك الموجود ولا اشتاقت 	فبان له بذلك عن أمها لم 	
( ١ ) في ط : يتفطن . 	
( ٠) 	١٤٥ 	
