٢٨ 	
ماطرت مضطر ا لأم ليس فيه مساس بقانون الرلاد . 	
فقالت بازق : ما هو ج 	
-لي حيمة بار يجارية يأباها علي أهلها. وقد اسطبدوها لأجل . فلحأت الى ماسمة 	
س وجتت أجث عنها اسى نتفاوض تدبير موافق لكطينا . 	تط 	
ما اممك يا هذا وما اسم 	طس ملجا العشاق . 	وي وى . اقد اصمحت ذ 	
حميتك ? 	
م. هذا السؤال . العادة عندكن أن اطاربات اليكن 	- مولاي أرجو ان تعفيني ب 	
بسبب غير مشين يلجأن الى الهيكل. وكنت مزمعا أن أقصد اليه لكى أسأل عن حبيبتي 	
نا سالي الى الهيكل وهناك يثبت 	هناك،اعتقلت قبل أن أي الليل . فأرجر أن تسمحي. ر 	
صدق دءواى 	
لا أحدب طلسك الا إذا اعترفت هويتك وهو ية حبيستك . 	
- مولاي اعتقد أن قضاء الأمازونيات الجليل التريف يسمح لي بكان هويقي 	
٢ على كرامتنا. وأظن ان ابلاغك امري الى قداسة كاهنة الهيكل الجلية 	وهور4 مدم رهه 	
عناء التحقيق . 	موك و رفي من 	
وهنا زادت اوجستينا اودينا وقالت لها ردي هذا المعتقل الى كنه نم لعالي . 	
-١ -كتب على رق صغير : 	وحرجت اودنا بالمعتقل وشرءت اوجسدسه 	
« الى سيدلي الورعة الممجلة رئيسة اللأهنات في دار القضاء 	
«عندي رجل جار يجاري متدر معتقل يزعم أن له حيمة لاجئة الى الهيكل فرارا من 	
اضطهاد أهلها لأجله . ويأى أن يبوح بامميهما . فاذا كانت عندك هذه الفتاة فأرحو 	
-ق ي دعوى هذا الممتقل » 	أن مرسليها مخفورة الى دار القضاء لأجل التحق . 	
اوجستينا 	
سيدة القضاء 	
مم لفت الرق وربطته بشر يط أهر . ولما عادت أودينا قالت : أرسل هذه الرسالة الى 	
الهيكل. ل اتينى بذات العذار، لأنه ياو ح لي أن هذا المتنكر الاخر الذي كاذ في الفندق 	
ليس القمر الساطع الذي م عل الدر حين ا5داد القمر . 	
لا ٠ ك هابط يا سيدي . 	حقو ر 	
أمل أنان أن فات المذار مي بيت القعيد. 	
لمم هي بيت القصيد الذي يصعب تفسيره . 	
