٥ 	
فبتفت المؤ عرات : «تعيش الماركة » ملاما. 	
مم فال أوجسقنا : اذن يجت أن نتحقق موعد خسوف القمر فقد يكون قرننا . 	
فقالت المدكة مؤ ممنة عل كلام وزرة العدل : على جرمجوريا وزرة الشؤ ون الاجناعية 	
ستدعاء المنحمة الان لاستفتاا. 	
.رموريا لقضاء هذه المهمة واستمرت الملكة تقول : حذار أن تتسرب 	لحرت ح 	
ة من هذا المجلس الى الحارج لثلا تضج البلاد بالأقاويل والأراجيف التي عكن أن 	
بقيت الفقرة الثانية من لطق الهيكل « الويل مم الويل إذا انتصر كيو د 	تحدث شغما . 	
يل أجكس إلـه القوة حين يقترن القمران » . 	
ر من هذا النص أن المراد بالقمرين 	فقاات فاومينا سيدة المحافظة معلى الأمن : الظاه 	
القمران المذ كوران في الفقرة الأولى : القمر الساطع والقمر المكد. 	
فقهقءت أوجستينا وقالت متوكة : أي نعم : اسبط قر الأرض الساطع لثلا يفر إل 	
وهترن به. 	قر السباء المـ كد 	
فقالت الملكة متحققة أمرا همها . ألا يحتمل ياسيدات أن يكون المراد اقتران 	
القمرين مرور الى جل على السر مع حدوث الحسوف في وقت واحدج 	
عفو مولاي . إذا كان هذا هو المراد فالفقرة الثانية تكرار للا ولى 	فقالت أوجستينا : 	
و أطق الهيكل " يمجل عن التكرار الفضولي أو التو كيدي لأه أكيد بلا توكيد . 	
فقالت أمازونيا رئيسة الوزارة باسمة : هذا كلام شخص عقوقي قاو في منطيق . إذن 	
فلا بد أن يكون المراد اقتران ذكر وأنتى في بنطس على كل عال . 	
فقالت فاومينا كأها تتشق : أجل الويل لها. هذا تدنيس للشريعة . يجب أن يشاد 	
هيكل حقير لكيوبد ويحرق المجرمان على مذبحه لسي يختنق كيو بد بدخان محيته . 	
حره : وحينئذر يهب أذ تعيني حارسات مراقبن ذك الهيكل ليلا 	فمالت أوجستينا سا - 	
و محصين الأمازونيات اللواي يدخلن خلسة اليه و يجدن لاله الحى 	
واجعلي فرق باي الهيكل سيفا يسقط تملى كل عذق يشرثب إلى داخله . 	
اذري أذ يقع سيهك خطا على عنتقاكر لا مزبزي . 	
- سيي لا مخلىء . لا يقع إلا تلى كل من عد عنقها الى هيكل الغرام . 	
فقالت الملكة متململة من هذا الحدث كأها مي المقصودة فيه : إذن فعليك 	
يا فاو مينا أن تستخرجي القرينين من مخبئهما ولو كانا في أعماق الحفاء . 	
تفهم ماذا هنى الهيكل 	فعادت أوجستينا الى لاب الموسوع وقالت : إذن يرب أن 	
