١ 	
ط ف لسة للاعداء 	و محك الحب عدو" استقلالنا ، او اعتنقنا عقدتك هذه اوقعت بذ س ر 	
. أقر قميه لنا 	منم الأعداء ، ألد 	فقالت أوجستينا هازئة مقهقة : حذا الأءداء ! 	
قبيلة حار يجاريا ؟ وفيها اباق ذا واخوتنا و بنو با ، وقد ازدحمت بالذ كور الذين نلام و برسلهم 	
ث ، وازدحمت نطس بالا. ناث الواي نلدهن ولستقمى 	٣ وقلت عندم الأا 	الى آا 	
غزانا أهل جار يجاريا كنا بمحن مفترسا رهم لا مم مفترس و 	فاذا 	
- الويل لثر أر يدرن أن نفترس أقرب الناس المنا 	
- وما قولك اذا كانوا يغتبطون كل الاغتباط بهذا الافتراس ? 	
معارك 	فقالت ملفينا متالهة : يا لك من مماحكة. أيغتبطون في ان تكون نطس 	
أبطال تتدقق فيها دماؤ م الامهار ؟ 	
فثارت أو حستينا مازحة : أي لعم يغتبطوذ في أذ تكوذ بدطس معارك غرام تتدفق 	
قاو را دماء الح 	
وقاات ملفينا ميادة بالتاله ومستلذة هذا النقاش 	
- أهذه المعارك تعنين 	اوه 	
ممارك الاحداق وامرج . 	
هذه معارك لا نستط م. الانتصار فيها. ينتصر فيها الرجال وأصبح م مير 	
إماء ورقيقات . 	
س وعز ون لا مارين 	بل يكون النصر لنا حيا. يدخل رجال جاريجاريا الى بنط 	
ويكونون لنسابا غنامم لا نامين . 	
- ان تقالدنا وتواريخ جداتنا تشهد ضد هذه الاماي التي بمنين الدهس بررا . ما 	
اعتصبت جداتنا ضد ارجال الا لى يسحقن نير العبودية لهم . فبل ويدين أن لهود الى 	
ذللاك النير الثقيل . 	
اسف ان للتقلد سلطانا عل عقلك يأعزبزلي . عند 	فقالت اوجستينا حادة 	
الاختمار مجدين رجال هذا الزمن في معارك الغرام أسارى ونساءه اسرات . 	
- وقينا من ثر لظريتك يا سيدة القضاء . أما كانت معارك الغرام محتدم في أز مان 	
ج دانما القدءأت ؟ فاماذا كانت حداتنا اسيرات لا اسرات، ورقيقات لا سسدات 	
" أأت اوجس تينا جازمة كالأ لم محدث ممارك الغرام في زمن جداتنا لا هن كن 	
يتمتعون، بهن لغير اقتناص ا يتمتعوذ أ كل الغم والفراح والهام 	أسيرات وكان الرجال 	
ى بنصف المهمة ااتى لأتبت ي سهر محرير المراة . هن حررننا من 	إلا اهط اد. حداتنا 5. 	
