٢ 	
فيه علينا ان أستعمد ارجال، ولا سلاح لاستعبادم الا سام كيو بد 	اله.ودنة لارجال 	
فقاات ملفينا مضطربه : وكر اخاف ان كيو ند اله الح لعيث غراما الان فى البلاد 	
اع اي أحس 	وريش سهاما الى الأكاد اذا كانت سيدة القضاء تبادى هذه الفلسفة . 	
أة ناحية ريش هذا السهم الى هنا ،( ووضعت يدها عل قلبها تتهس). 	لو وع سهم ن" 	
ان يعيث كيو بد في بنطس ويرش السهام مل الدوام لأن 	فقاات اوجستينا : طمه 	
ب جو هر الطميعة ، فإذا عاث الجوهر في البلاد كان عيثه زهرا ججيلا و ثمرا يالما . 	ا 	
، ي نتق هذه ارعة 	واكن الى في ثر يعتنا جر عةيا سيدة القضاء والعدل فك . 	
- هر جرعة في شريعتنا ولكنه فضية في سنة الطيعة . ولا قبل لنا على مناهضة 	
الطسمة فما هو فضيلة فى شر لعمنا 	
لعة نشأت لمقاومة الطسعة . 	واـ ن الدر. 	
حقدا ما تقو لين . فلنر اهما تغلب وتفوز أخيرا يا عزيز في التاهنة التقمة النقمة. 	
اقاشنا هذا على رئيستك الكاهنة العظمى وإن كانت قد أوصتك أن مرقي 	بالطه لا تقصى 	
حوادث كيو بد في بنطس، أثق أناكر لا تفصين عليها هذا الحديث لانك شريكة فيه. 	
١٠٠٠ الى حيث كان الوقع فإذا رثيسة السكاهمات 	عند ذاك باغهما وقع أقدام . فالتمده 	
بادنة وهي تقول بصوت جهوري : 	
« فى الغد تكد القمر ومتقل اطب. فارقي القمر يا ملفينا» . 	
مم نوارت و ملفينا أجفلت وقالت : ومى لقد سمعت كل حديثنا . وسيزل الويل علينا 	
لا فافي. هلى سجدتر لكيو بد ، إذن لم تعصى الشر لعة . فاماذا مخافين 	
وأءرءت أوجستينا الى القصر لسك محضر مجاس الدولة . 	
ه 	
في دار الدولة في قصر الملكة 	
ركنا الماك في الفصل الازف تأمر بعقد مجلس الدولة في هوها ، وهو يحتوي على 	
السنط مزخر من الطراز اليو نافي القديم. وفي وسطه منضدة من خشب 	مقاعد . حش 	
مزخ فه وقد جلست الماكن أمامه وجلست حوله سامر سيدات الدولة، ما عدا الوسمفات 	
وحاشية الملك طعا . 	
وعل أرض البهو أبسطة بجيلة أغريقية الطراز وفي اللأوايا مناضد عليها عاثيل وأزاهر 	
