٢ 	
سيدونا حارسة القصر، وكانت أول من لمحت الى عدو لك عن الصيد ندءوى طروء 	
س اسسرة . 	مشاءا 	
فقاطعته الملكة : تسا لها . كيف تقول هذا و أوعز به لها ولا لأحد ) 	
طبعا رابني قولها فبرت مدعا لها إي ماض. الى الصيد ومتوكدا هما أى 	
أخبار الحقيقة عن قدوم 	اعود مساء حما . ولكني توجهت الى جهة العاصمة اتنس 	
ا نمائك خبر عدوك عن الصيد. وما زات 	من 	ة إلا تسقطت 	حاشدتك . فا رحلات مرح 	
أتقدم وأتذ هذا الحبر بعنه إلى أن وقعت في الفخ الذي أصبته لي على الجسر حيث 	
اعتقلتنى ٤ شرطات شاهرات الحناح البراقة علي . وجر درني من سلاحي وجن ي 	
فاذا لظنين خطر لي سبا لاءتقالي 	الى السحن . 	
وكانت الملكة شديدة الاضطراب والحنق وتالت : ولـكني أرسلت ملداف بعدك 	
اسكى تؤكد لك أي ذاهمة الى قمر الصيد، ملى قصد أن أتا كد أنك منتفظري . فمامت 	
ماء عل الذهاب الى 	فى الصيد فتركت لك معها خبر د ي 	مرهم 	ملدافى من ميدوثيا إنك 	
القصر وإلعازي نأن تبق فيه منتظري . فار رجعت أدراجك لوجدت أوامري مطمثنتك. 	
والا أدري كيف لسرعت . 	
ورمحعت باضطرا ترديد ومي تقول. الويل الويل الويل . 	
ر م 	وأفر ودوس، لا يهدم ما معنى هذا الويل لأنه لم يعل مخبر نبوءة الهيكل لا ا - 	
الملكة أن تدمره بهذا الحبر . فقال حينئذ : أي ويل اعظم من أن أفهم إنك أوعزت 	
باعتقالي لأن وعدك الساذب باللحاق بي لم يذجح في اقصاي . 	
فصاحت الملكة كالمجنونة : الويل الويل . واغرمتاه ! لم أقل إفي هدلت عن الصيد . 	
ريب إها من تدابير الاراه لسكي تم فبوم 	فـكيف انتشرت هذه الأشاعة الاذبة ? لا 	
الهيكل ، فواحرباه وانكتاه. 	
هذا التفجع والويل فقال : 	وما زال أفريدوس لا يمهم سر 	
بر دي ٣ 	-- الهيكل ؟ لمز 	ماذا كانت نبوءه 	
سر حين خسوف القمر . 	عبور رجل على ال 	يا للهول . ا. - 	
قاا : ما هذه نبوةة ، إن هذه الا مكندة من كاهنات الههيكل . 	فقبقه اريدوس و ب . 	
اذا كانت هذه المكندة قد أتقنت هذا الاتقان الغر ت المحيت ، فالاهنات 	
الالهة . ولذلك يج أن مخشى غضبهن . 	أعظم من 	
- ان تطيرك تخر تفهي" ساعد مكيدهن . أو اذ كيدهن أنتجت وهك الذي 	
