١٢ 	
وقمى وسهام وخناجر وحرا ور ح معلقة و 	أمام الواثيل . وعلى الأبسطة فراء . 	
اللإدران . 	
هم يا سدات 	وقد افتتحت الملكة الماسة بورع قابة : إن إنذار الهيكل ر 	
فتلمها أمازونيا رئيسة الوزارة بالقول : لا بد أن في نطس الان جر مه سره مدلة 	
قدسية رلعمها . فيجب لطهير البلاد منها . وإلا بزل الويل بالبلاد . وما الويل الذي يخشى 	
منه إلا ضياع استقلالها ووةوعها بحت زير العمودية لدولة جارجاريا الطامعة فيها . 	
فقالت الملكة : طمعا . لا إنذار إلا مجاه جر عة ، فالأمز الذي يجب بقيقه هو الر عة 	
بمسها 	
فقالت فاومينا مديرة الشرطة : طسعة الجرعة ظاعرة يا مولا ي في تفس انذار الهيكل 	
ومي «الورل إذا انتصر كيو بد إله المب ملى أجكس إأه القوة فالمر عة جرعة ح . 	
و) كتى وسوح مي جرعة اجتاع حبيبين في بنطس 	
فقالت أوجستينا متفلسفة . كيف يكون الحب جرمة و محن لولاه لما وجدنا. 	
ليس اللب جرمة الا في بدهطس وأما في مار تنا 	ففسرت أمازوفيا رميسة الوزارة : 	
حاريجاريا فلا . 	
عة هنا وفضيلة 	فقالت أوجستينا متماماة لا أفهم كيف يكوذ باموس طبيم جر 	
هزاك . أليست بنطس جزءا من الطميعة . 	
سمور بنطس ؟ وهل سئت الشر الع إلا لمقاومة 	- أمرك غريب . هل الطبيعة د - 	
الطيعة . 	
- دستور بنطس لا عم الحب . لا يحر م إلا دخول الذكور إلى البلاد . 	
ور م الحب فيها أيضا. لآن اباحة الحب تتضمن إباحة دخول ار جال . ودخو لهه 	
خطر على الاستقلال الذي اشترته جداتنا بدمان . 	
فتدخات المذـكة ين أوج سقينا وأمازونيا حسما للزاع في سر الحب وتالت : يج أن 	
تفسر لطق المهيكل كلة طة لى محدد المر عة التي اقتضت هذا الا نذار المروع . 	
و سح بإ مرلاي. الفم الساللع رن اثيء . فبلى مكن أن 	فقالت فاومينا: الته ا. 	
يكون رمزا إلا للمرجل . 	
فقهقهت أو جستينا منهكة وقالت : ألا يحتمل أن يكون رمنا لجام أو لغزال أو لتيس 	
الجسر . 	
