ه 	
أما أنت فتذوقينها باليقظة . يمق المرش الجاريجاري متقلقلا الى أن تستوي 	
أنت عليه . والدولة تبق قلقة الى أن تقبضي على صو لجاها . هل انتقلي من هذا المرش 	
المماره من المخاوف والانذارات الى العرش المطمن الوطيد. 	
- والشعب الجاريجاري ماذا يقول » 	
- يغتمط عظ الاغتباط إذ يعد جاوسك عل عرشه انتصارا لالهه . 	
كبنته 	ودمالأى 	
محبط لدى انتصار الههم . 	
وهل يجل شمبك ماذا يكون حقد الأمازونيات وغضبهن وهن اللاواي قد 	
الأقطار وفتحن الأمصار . 	دو عن 	
" حالما يبرز كيو بد لهن بسامه 	تنول قو ن 	
وجي من ينقدي من غضب اجكس وأرس العظيمين ٩ 	
لا يتجاوز غضبهما حدود بنطس . وسحركيوبد يخبلهما ويشل عضلات 	
الأمازونسات ا شل عضلاتك . اعتنق دين كيو بد فبو أقوى الآلهة وأوسع سلطانا 	
وأفعلها سحرا وأمنحها للسعادة والهناء . هو اله مججيع البشر.ابدلي الها بالو وعرشا بعرض 	
ه و. 	وحداة سعادة محنا 	
- وأفقد عطف أمتى وحبها وأتعرض لحقدها . 	
- بل تكسبين عطف شعب اخر مع عطف أمتك الي ستتوسل بك الى اهتناق دين 	
كيو بد والة نعمة الحب التي مجود بها يد الطميعة . 	
ويلي . وغضب كاهنات الهيكل ? 	
ق كار يح لصدم الصخر الجامد والصخر لا يكترث لأن الأمة تتمرد على الـاهنات 	
الواي آن عقبة في سبيل الصياعون الى صوت الطبيعة المو 	
لك من سامر خالب تكاد تزين في الهردوس في الفلاك السا! 	
- اجل إن ذلك الفردوس مفتوح الباب للترحان نك يا حيبتى . فلنمضر اليه حالما 	
ينسدل الظلام . 	
