با لأماندة القدر. كان القدر كالسيف ذي احدين 	(ازت الإاسكة نوك. مليا مم تالن ) . 	
ثعر من الجانيين . أنا أيجث بالتشديد في التحقيق لافي لم أ كن أعل أن القدر ر ماك ف 	
ند القضاء وأنت عر دت على قات متلهف . فاتفق الأمران على قضاء صارم . 	
هل كنت تعدر ين مطاوءي لمساومة أوجستين لو عاستر إي أا الواقم فريسه رين 	
رائن القضاء . وان مجافي تتوقف عل قبولي شروطها ? 	
... لا بل. اسكن لا بأس . ماذا كان في الأم لو قبلت 	فقالتمر تكة : 	
أ) ح 	
-و الدقيق خطرا 	أفا كان التحق" 	فقال افر ندوس مسمهحنا : اوه لوكان الحنث شدمى 	
عليك ? إذ محتمل أن أخوذ عهدك أيضا لى أمجو من الموت. 	
أوه. ويلي . وهذا ما يجمل الموقف الآن اعقد من هقدة الاسكندر. وا ذكتاه ا 	
الاسكندر لأل العقدة ؟ 	لفي إسيف 	من 	
لرمة القدر 	الأم إهط . لا بهدم 	
ويلاه . كيف أومسن القدر وقد بدرت بادرته الهائاة . ا بالا.عدام . 	
اعتبرى علاقتنا الماسة حاما قصيرا وانقضى 	
كيف ينقضي وهو مطبوع في مخيلتي ولا عكن الزمان أن بنسخه ? 	
حسي ح ب الموت مقدرا لكل إنسان! واركيى لنقمة القضاء قمل أن تثار 	
الظنون . 	
فقالت مضطربة : مستحيل ان اساماك انقمة القضاء 	
الا هذا السديل لا فقاذ حماتك وعرشك . 	أ بين، 	
وما لذة العرش بلا حميب . وا اوءتاه . لا اسامك 	وما الجدوى من الحياة لا ح 	
للقضاء ولا لنقمة الهيكل إلا وأنا معك اتلى هذه النقمة الهائلة بصدري اكيلا أراها 	
منقضة علمك . اه دءي أعزي الدهس فى إبان اسها . 	
م طو فت ءدقه بساعدها وتالت . سأستكد قريتي لاختراع وسياه للهر ج . 	
وتحت الباب واستدءت أو جستمنا وقالت : ردي هذا المعتقل الى كنه وعودي إلي 	
نا محنت أوجستينا وقادت الممتقل الى الحجرة السرية حيث كان حدسا. ولما عادت 	
ن جراج سره من صدره 	امميقا. ولابدم است. 	الت الملكة ياو ح لي أن لهذا الفتى سر 	
لذلك يؤ ج-ل إعدامه اثلا يدفن سره معه . انتظري مني أمرا باستدعائه إلى قصري عمى 	
