١٣٨ 	
معها بقية الليل فى الحديث ... ولكيى لا أكاد أسعى إليها حيى 	
تأخذنى الأشباح الحمراء من كل مكان ، وحى تسعى إلى أختى وعل 	
وجهها ابتسامة شاحبة حزرنة مستعطفة ، وهى تلو ى ش هذه 	
الكلات الى تقع منها مواقع السهام المحرقة : لاتوقظيها إسها تخيفنا ، 	
وإن يقظها تطردنا ، ماذا تخافين منا ؟ لقد طالما ألفتنا وألفناك ، 	
أفنسيتنا إلى هذا الحد ؟ ! كلا ! كلا ! لم أنكن ولن أنساكن ، 	
ولن اذودكن عن نفسى ، ولن أوقظ هذه المرأة الى تخيفكن . أقمن 	
معى ، أطفن ى ، تحدثن إلى ، فن يدرى! لعل أن أكون ف يوم 	
من الأيام واحدة منكن ، لعل أن أكتسى هذا الرداء الأحمر القانى 	
الذى تكتسينه والذى يدعونى إليكن وخيفى منكن . ، 	
وهذا صوتك أيها الطائر العزيز يحمله إلى" الهواء من بعيد فيبلغى 	
نحيلا ضئيلا ، ولكنه عل ذلك يشيع فى سكون الليل كا يشيع الضوء 	
ف ابلدو ... 	
وهذا صوتاك أيها الطائر العزيز يدنو منى شيئا فشيئا فيماؤى أمنا 	
؟ «ما . إنه يردنى إلى اليقظة الحالصة التى سعر 	ودعة وهدوءا ؛ وحر 	
به وتقدير له ، وتستقبل 	بنفسها وتفكر في نفسها وتذكر ما مضيى عل عل 	
. ق رويه و بصيرة واستعداد للاحنال . . 	ما سأ؟ 	
! إن صوتك إعلا أذلى ، وإنه يعلا قلى ، وإنه ليغمر 	
ى : وإى أفهم عنه ما يريد ، وإى لأذكر أخى ومصرعها ، 	
وإى لأعرف من دفعها إلى الموت ، كا أعرف من أذاقها الموت . 	
العا ألى ساعية إذا كان الغد إلى بيت هذا المهندس 	وإن لأعام حق م 	
فناهضة بما كانت تهض به أ ب 	مقمة فه حث كا اجى . 	
