م١٠٣ 	
- ، وأفهم وليتى لم أفهم أن أسرة 	حى أولم - وليتى لم ) 	
المهندس مقبلة من القاهرة إذا كان الغد لتقي مع ابنها أياما أو أسابيع ، 	
وان هذه الز يارة ليست كغيرها من الزيارات ، وإما هى زيارة تم لامر 	
يراد ، فستخطب بنت المأهور للمهندس الشاب ، وستشهد المدينة أهراحا 	
لم تشبدها منذ عهد بعيد، وسيسمع أهل المدينة من ألوان الغناء ما لم يتعودوا 	
ان يسمعوا من قبل : فلن يقرأ عليهم المولد هذا المغبى المشهور الذى يقي 	
فى عاصمة الإقلم والذى يتعصب له أهل العاصمة وما حولها من القرى 	
وما يجاو رها من المدن . ولن يقرأ هر المولد هذا المغبى الآخر الذي يقي في 	
اقصى الإقل نحو الشبال والذى ينافس صاحبه أشد المنافسة ويتعصب 	
نصف الإقلم أو ما يقرب من نصفه . ولن يقرأ هر المولد الشيخ مدكور 	له ، 	
هذا الذى يقه في المدينة نفسها ويحبه أهل الريف، ولكن شهرته لاتتجاوز 	
المدينة إلا قليلا . لن يقرأ ه المولد واحد من هؤلاء المغنين ، ولكنهم 	
لمغن" يأنى من القاهرة ، قد يكون عبد الحى ، وقد يكون الشيخ 	سمسمعو 	
يوسف ، وقد يكون غيرهما من كبار المغنيين . وستأى العوالم من القاهرة ، 	
وستأى مغنية مشهورة لتطرب السيدات ، وستقام الزينة وتولم الولامم عل 	
أحسن طراز وأجمل شكل ، وسيأى المنظمون لذلك والمشرفون عليه من 	
م يفيضون ى 	القاهرة لا من المدينة ولا من عاصمة الإقليم . وكان الحد 	
ذلك ، وجرون فى تفصيله مع هذا الحيال الريقى الساذج الذى محسب أنه 	
يمضى أمامه إلى أبعد أمد عل حين لا يزال ى مكانه لم يتجاوزه أو لم يكد 	
يتجاو زه إلا قليلا . 	
كانوا يفيضون فى الحديث عن المغى والمغنية ، وفى الحديث عن الطهاة 	
