٥٨ ١ 	
العمل ، ولكنى احتفظت دانما بعقل ولم يخرجنى الحب كا لم يخرجني 	
البغض، ولم يخرجى الأمل كا لم يخرجنى اليأس ، عن طورى فى لحظة من 	
العبث فيه . 	اللحظات . لذلك أجبته صادقة بأن هذا أمر لا ينبغى 	
قالى وهو يضحك : فإنك تظنين أى أعبث ، وتقدرين ما بينك 	
وبيتى من الفرق الاجياع مى تزوج السيد الغى المنرف من خادمه 	
الشقية الفقيرة البائسة ! أليس هذا هو ما تقدرين ؟ فأريجى نفسك 	
إذن من كل هذه الحواطر ؛ فقد رايت منذ موقفنا ذاك فى المدينة أى 	
لست سيدا كغيرى من السادة ، وقد رأيت أنا منذ عرفتك أنك لست 	
خادما كغيرك من الحدم . لقد دهشت حين رايتك تنتظرينى إلى آخر 	
الفتيات اللآنى سبقناك إلى خدمى ، 	الليل عل غير ما تعودت من 	
ولكى لم أكن أقدر أنك ستثير ين فى نفسى ألوانا أخرى من الدهش . 	
م أطرق صامتا فأطال الإطراق والصمت ، ولبثت ماثلة ذاهلة 	
لا أقول شيئا ، وأكاد لا أعى شيئا ، ولكنه رفع رأسه ، وقال فى صوت 	
هادئ حزين : أتقبلين ؟ قلت ى صوت ليس أقل من صوقة هدوءا 	
ولا حزنا : فإن سيدى يعل أن ليس إلى هذا من سبيل . قال : تفكر ين 	
فى أبوى ! فإى قد فكرت فهما قبلك وقد حزمت أمرى ، وما أشك 	
أهما لن يمتنعا على ،. ولو قد فعلا لعرفت كيف أمتنع عليهما ، 	
ولكما لن يفعلا ، فهل تقبلين ؟ قلت : ليس إلى ذلك من سبيل . 	
وال : من حوى عليك أن أفهم هذا الامتناع ، إنك لتعلمين أن فراقا 	
بيننا مستحيل ، وإى لأعا كا تعلمين أن ليس لقلبينا رضا إلا فى 	
ومن ذا الذى 	الزواج . قلت : فقد قضى عل قلبينا ألا يرضيا . قال : 	
قضى علهما هذا العذاب المتصل ؟ وشممت أن أجيب ولكن صوى 	
يحتبس . ودمع ينطلق ، وإف لأرانى أه بالانصراف ، وإنى لأراه 	
محلسه متثاقلا وسعى إلى متباطئا حى ردى ى هدوء ودعة ، 	قدد -اقس من . 	
