المحاورة ، فاصبحت دل واحدة ههن سيدة في البيت أو سيدة فى الحيام 	
واستقبلت حياة فيها الجد والعمل والكد ، وفيها الأبناء والبنات وما يستتبعون 	
من ببجه وقرة عين ، ومن شقاء وحزن وامل وإشفاق . انظرى يا ابنى 	
الكبيرة إلى كل هذا النور الذى يصبه الضحى عليناصبما والذى يغمرنا، 	
والذى تمضى فيه كأيما نخوض بلحة البحر ، انظرى إلى هذا النور الذى يغمرنا 	
ويغمر السهل من حولنا؛ وانظرى إلى هذه الحقول تنبسط عن عين 	
وشيال لا تكاد تنتى؛ وانظرى إلى هؤلاء الرجال والنساء وإلى هؤلاء الفتيان 	
ف" 	والفتيات وقد ملا النشاط، وبعت فيهم الجد حياة لا حد ها ، 	
يذهبون ويجيئون وهه يعملون لا يعرفون كلالا ولا سأما ، وأصواهم ترتفع 	
لا بالشكوى ولا بالأنين وإبما ترتفع بهذا الغناء الساذج الحلو الذى يبعث 	
فى هذا الجو نغات ساذجة حلوة ، والذى يصور الأمل فى غير إسراف ، 	
والرضا فى غير استكانة ، والاطمئنان فى غير حزن ، وحب العمل عل 	
كل حال ، والثقة بالله عل كل حال أيضا . 	
١ نرين أو في 	انظرى يا ابني واسمعى ، مم سل نفسك: أتجد، فه 	
خوها او يبعث روعا أو يدفع إلى يأس ) كل ثىء آمن 	سسمعي ما سهر 	
هادى وكل أىء يدعو إلى 	وكل شيء يدعو إلى الأمن ؛ كل ثىء 	
الهدوء . إن ظلمة اليل لمنكرة وإمها لتحب الحوف وتثيره ، وإمبا لتبعث 	
الأشباح من مكامنها ، وإسها لتغرى القلق بالنفوس وتسلط اله عل 	
بمى تثيرين ى شسى مثل ما كان يثور ى 	القلوب . . . لقد كنت يا ا 	
نفسك من الحوف حين كنت تتحدثين إلى" وظلمة الايل تغمرنا من كل 	
مكان ، فأها الان وقه انجلت هذه الظلمة وأصبحت لا أمد عيى إلا 	
