١٣٦ 	
بأنه سيقدم ، مطمثنة إلى أنه سيحين . ولم أظهرها عل هذا كله ، 	
وأمرى كله فى حاجة إلى الحزم وفى حاجة إلى المكر والكيد . 	
بشىء ، ولم أنبئها حين أصبحنا بأنى 	فعم ! لم أنبئها من هذا كله 	
لم اذق النوم لحظة فى هذه الليلة الطويلة الى فرقت بين نفسين ، وإعا 	
قضيت الليل كله يقظة ، أفكر فى أمس البعيد وأفكر فى اليوم 	
وأفكر ى غد وفيا بعد غد ، عل حين كانت تحلم بما باعت وما ستبيع 	
من حب ، وبما أخذت وما ستأخذ من أجر ، وبما ذاقت وما بى لها 	
أن تذوق من هو ، وعل حين كانت أحلامها هذه المختلفة تدعو جسمها 	
إلى أن يأنى حركات مختلفة تلامها ، وتدعو لسانها إلى أن ينطق بجمل 	
متقطعة متلفة توافقها . وكنت أرى ذلك ما وأسمعه ، فأرنى ها وأرثى 	
لنفسى أيضا : أرى ها في حيامها هذه الصغيرة الحقيرة التى خلت من 	
كل حس دهيق ، أو شعور عنيف ، أو تفكير عميق . وأرى لنفسى 	
من حياتى هذه المضطربة التى يملؤها الحس والشعور والتفكير ، وتفعمها 	
الأحداث والحطوب . 	
! قضيت الليل كله مؤرقة ، وليس من شك فى أنه كان طويلا ، 	
وليس من شك فى أنه كان ثقيلا لو فرغت له ، ولكنى شغلت عن الليل 	
ببنات الليل . شغلت عن طول الليل وثقله بصورتك أيتها الأخت العزيزة 	
البائسة هذه التى لم تكد تحس أى خلوت إلى نفسى حى تراءت لى 	
دنت إلى م استقرت مى غير بعيد ، م أخذت تتحدث إلى نفسى 	
حديثا أعقله ولا أسمعه ، وأجد له فى قلى وقعا لاذعا حلوا معا . صورتك 	
حين ذهبنا إلى الغرب ، وكا كنت 	هذه التى رأيتها كا كنت أراها 	
السياء ذاهلة لا تحس شيأ ولا بلممت 	أراها فى بيت العمدة قامة تحت 	
