٠ ١ 	
أ تكلف أو مجاولة ، وإما أنا أكذب وأنافق 	ولا آخذ نفى اتمج د 	
واصطنع الرياء وأخى ما أخى وأظهر ما أظهر ، في سبولة ويسر ، 	
أتنفس وكا أفتح عيى وأغمضها ، وكاآتى ما تدفعى الغريزة إلى أن 	
آى به من الحركات ! ومع ذلك فبعض ما عرض لى من الحطب وبعض 	
الحياة فضلا عن الحياة 	اكان خليقا أن يحول بيبى وبين 	ما ألم ب من 	
الهادئة المطمئنة ، فضلا عن هذه الحياة المضاعفة النى ملؤها الكذب 	
و يجرى فيها الرياء كا يجرى الماء فى الغصن الرطب . 	
١٧ 	
وانسى النبأ إلى خديجة ، كا تنسى هذه الأنباء إلى الفتيات من بنات 	
الطبقات الوسطى . ظاهرا خفيا ، وواضحا غامضا ، يلى إليها ويسر 	
فتبهج له نفسها وتستحى مع ذلك من أن 	عمها ، تنبأ به وترد عنه ، 	
تتحدث فيه ، ويمتل" له قلبها غبطة وسرورا ، ويفرض عليها الأدب 	
-ذلك أن تتكلف الكآبة والحزن كل ذكر لها ، وان تعرض بوجهها 	
أعراضا كل هم أحد أن يشير إليه من قريب أو بعيد ، وأن تفر منه 	
فرارا إذا كان الحدديث فيه إليها صريحا جليا . عل أن صديى وإن تكلفت 	
من ذلك ا يتكلفه أمثالها مع من كان حوبها من أهل الدار ، قد آثرتى 	
ثىء من هذه الصراحة الساذجة الحلوة ! 	تما كانت تؤثر به و كل 	
عل ما كان يملا قلبها من فرح وغبطة ، وما كان يغشى 	فا تخف 	
لمسبا من قلق وإشفاق ، وما أكثر ا تحدثت إلى" وما أكثر ما تحدثت 	
