١٣٤ 	
عن صمهم حين صمتوا ولا عن قو حين قالوا . ولكن النتيجة الأول 	
والأخيرة فيا أظن لهذا كله هى أنى طردت من الدبار طردا . ورجعت 	
بيت زنوبة وإلى غرفتها ، فقضيت فيها أسابيع أنتظر ما يجرى به 	إلى 	
القضاء ، وما تنتى إليه حيلة البستانى الذى ضوعف له الأجر . 	
٢١ 	
« ستعملين إذا كان الغد يا آمنة ، وستعملين علا يرضيك كا 	
لم يرضك عمل من قبله قط . لا تذكرى بيت المأمور ، ولا تذكرى 	
بيت فلان هذا الذى دفعتك الحماقة فيه الىهذا الذئب العظه. ستعملين 	
عملا مريحا فيه مال كثير ، ونعيم كثير ، ومتاع كثير . ستعملين . . . 	
سى تعود إلى حيث 	ليتى كنت مكانك ، ليت 	ستعملين وستسعدين . 	
أنت من العمر . ستعملين وستسعدين ..١» 	
قالت ذلك وهى مضطربة أشد الاضطراب ، مبتهجة أشد الابتهاج 	
يدفعها الفرح والمرح إلى أن تأنى حركات مختلطة فيا الرقص والقفز 	
وفيها ابلحد واهزل ، وفيها الدعابة الى ليس بعدها دعابة والمجون الذى ليس 	
بعده مجون . حركات عل الوجه ، وحركات باليدين ، وحركات فى 	
الحسم كله مجتمعا وفى أعضاثه متفرقة . حركات هى إل الحنون 	
والاختلاط أدى منها إلى الفرح المعتدل الذى يصدر عن نفس مرحة 	
هى ، وإما انقضت عل 	وعقل متزن . ولم تكتف زنوبة باضطرامها 	
انقضاضا ، فقبلتنى وأمهضتى وراقصتى ودارت لى حول الغرفة دورانا 	
متصلا سريعا حى انهت ى وبنفسها إلى السقوط ، كل ذلك وهى 	
مندفعة في حركاها وأحاديمها ، لا تمكننى من أن أقول كلمة أو أنطق 	
