١٤٠ 	
م يقبل آخر الليل ولم يكن يقدر أى سألقاه قابمة باسمة . أقبل إلى فى 	
ظلمة الليل يسعى كأنه الحية أو كأنه اللص . ولكنه لمم يكد يبله باب 	
الغرفة ويتبين شخصيى ماثلا فى وسطها وعل وجهه ابتسامة شاحبة كأزها 	
شىء من الذعر ، فتراجع خطوات م 	ابتسامة الأشباح ، حيى أخله 	
قال ف صوت أبيض جعل يأخذ لونه الطبيعى قليلا قليلا : ماذا ؟ 	
ألا تزالين ساهرة إلى الآن ؟ أتعلمين أين أنت من الليل ؟ قلت: لقد 	
جاوزت ثلثيه ، وما كان ينبغى لى أن أنام قبل أن ينام سيدى ، فا 	
العله يحتاج إلى فى . 	يري 	
من وحته 	شيئا 	قال وقد عاد إليه ثباته وهدوء نفسه ، واسرد صوته 	
العناية 	المألوفة ودعابته البغيضة : ما رايت قبلك خادما مثلك تح 	
بسيدها وتسهر منتظرة لمقدمه إلى آخر الليل . لقد كنت أحسبك نابمة 	
تعودت أن أرى «ن سبقك فى خدمى ، وكنت أقدر أنى سأجد فى 	ا - 	
إيقاظك بعض الجهد ، فلست أدرى ما بال نوم الحدم يثقل جى كأسم 	
اموات!.قلت: فقد أرحت سيدى من هذا الجهد ، وانتظرت مقدمه 	
كا تعودت منذ اصطنعت خدمة المنرفين الذين لا يحبون إنفاق الليل فى 	
: فليأمر سيدى بما يزيد . قال وهو يضحك ضحكا سمجا وقد 	دور 	
مد إلى يدا وددت لو استطعت قطعها ، ولكن تراجعت حيى لا تبلغنى : 	
فإن سياك أهرك أن نتبعيه . ثم انحدر إلى غرفته ووضيت فى أثره ... 	
وصادق المسكين ألى كنت أنتظره . ولو قد نفذ إلى قلى واستمع إلى 	
مر 	أحاديث نفسبى لعرف أى لم أكن أرقة فى انتظاره ، وإيما كنت أسا 	
أشباحا حمراء لو رآها مل" قلبه رعبا ولولى منها فرارا . ولكن لم ير إلا إياى ، 	
ولم يفكر إلا في . وما له وللأشباح الحمراء! 	
