٦٩ 	
وابتئاسا ! يا ها من ظلال تذهب وتجىء هادثة لا تكاد تشعر ولكن فى 	
حر كاسها ما يملا النفس جزعا وهلعا ! ما لى لا أثبت عينى فى هذا الظل 	
المقه ، ومالى لا أثبت عيى في هذه الظلال المضطربة البى تذهب وتجىء ؟ 	
أنامة أنا أ مستيقظة ؟ أعاقلة أنا أ ذاهلة ؟ ألست أتبين فى هذا الظل 	
المقه ملامح أختى فا لها إذن لا تكلمنى . . . وما نلها إذن لا تدعوف . . . 	
وما ها إذن لا تناجيى ؟ لقد عرفتها محبة لى واثقة فى مطمئنة إلى ، فا لها 	
لا تظهر لى شيئا من هذا الحب ، ولا تبدى لى شيئا من هذه الثقة ، 	
ولا تبين ل عن شيىء من هذا الاطمئنان ؟ إتما هى مكبة عل هذا الينبوع 	
تبحث فى هذا الينبوع ؟ 	تنظر فيه كا تنظر الفتاة الجميلة فى المرآة . عم 	
أتراها تلتمس صورمها فى هذا الدم المتدفق ؟ وما ها لا تكلمنى ، أليست 	
سمعى ؟ ما لها لا ترق لى ولا تعطف 	تجيبى ، أليست " 	ترانى ؟ ما لها لا - 	
على ؟ أليست تسمع هذا النداء الذى ينبعث من فى باسمها في صيحات 	
قوية عنيفة متلاحقة ؟! إى لأسمع هذه الصيحات ولكنى لا أرى من 	
أخبى أها تسمعها ، وكأن هذه الصيحات تخيفها وتزعجها ! فهذا ظلها 	
يستخو وتستخى معه الظلال الأخرى ، ويستخو معها الينبوع الأحمر ، 	
وهؤلاء أشخاص آخرون يسرعون إلى ويدنون مبى ويستجيبون لى ، فلا 	
أتى 	أكاد أنظر إليهم حتى اتبيهم ، م اخافهم ، م ابغضهم ، م 	
محضره بالصمت والهدوء . . . إسم أهل الدار قد سمعوا صياحى فأقبلوا 	
يرفقون ى ويسألونى عا أجد . 	
إسم أهل الدار ، وما أشد بغضى لأهل الدار . إى لأرى بيهم 	
أى وإى لأكره أن أرى أبى . كلا ! لأكف عن هذا الصياح لعل 	
