١٢٢ 	
آسف لما فاتى من حبتها فا ايكن من ذلك بد! ولكن أى أسف واى 	
حزن واى لوعة وحسرة ، واى ندم يذيب القلب ويملا النفس كآبة 	
ويأسا هذا الذى كنت أجده إذا أصبحت وامسيت وقضيت الليل والمهار 	
شمل باليد أو حديث مع أهل الدار لا متاع فيه للعقل ولا لذة فيه 	
للقل إ! 	
أين القراءة مع خديجة ، واين القراءة منفردة ؟ أين هده الحتب 	
العربية وهذه الكتب الفرنسية التى كنت أنفق معها أكثر النهار وشطرا 	
من الليل قارئة أو متحدثة عما قرات أو متمنية لاستئناف القراءة ؟ لقد 	
بيت لا يقرا من أهله 	تركت هذا كله فى بيت المامور ، واقبلت إلى 	
أحد ، إلا رب البيت : فإنه يقرا إذا أصبح ، ويقرا إذا أمسى ، وانا 	
أسمعه فى الصبا والمساء . وأكاد أحفظ عنه ما يقرا، وما يعنيى مما 	
أنا. هذا . 	يقرا ! إما هى أوراده وادعيته . ودلائل الحيرات . واين م 	
! 	واين هنا مى 	
م أستصي كتابا . وما كان 	ولمد خرجت من بي الامور 	
لى أن أستصحب كتابا ، وإما كانت كلها كتب لحديجة. ولقد 	
مرة ومرة : أين يمكن أن أظفر بهذا الكتاب " 	سألت نفسى ألف 	
مدن الريف كتب تباع إلا هذه الى يعرضها 	فليس فى هذه المدنة .. 	
الطوافون فى أيام السوق أو في يوم الحميس من كل أسبوع . يعرضوهها 	
فى السوق ويمرون بها عل الدور ، وليس لى فيها أرب ولا منفعة . 	
لا أ حسنه . وصلوات 	ه قصص لا تعجبى ولا تروقى وسحر 	إعا 	
دينية لا أعرف سها قايلا ولا كثيرا . 	
