١٢٦ 	
ألمس مخرجا لى من هذه الدار ومخرجا لسكينة من تلك ، وأريده مع ذلك 	
أى أجتنب الشر والإساءة ما وجدت-إلى اجتنابهما سبيلا، وكثيرا ما 	
سمعت سادى يتحدثون أثناء الغداء أو أثناء العشاء عن مبادلة 	
فيها أكبر أبناء الدار وكان موظفا في إقلم بعيد ، وكان ير يده و ير يد أهله 	
أن ينتقل إلى المدينة البتى نحن فيها ليعيش بين أهله سعيدا موفورا ، 	
فكان يسعى فى أن يبادل موظفا ى المدينة ليأخذ كل مهما مكان صاحبه. 	
وكان التراضى قد م بينهما بعد أخذ ورد وبعد سعى وإلحاح . وكان 	
وكان 	السعى متصلا فى أن ترضى الحكومة عن هذه المبادلة 	
وكان 	هذه الاسرة ويبعد حنا آخ. 	الأمل ينو حينا من 	
ر البيت وربته يحرصان عل تحقيق هذا الأمل أشد الحرص ويكثران 	
الحديث فيه ، وكانا يتصوران ابنهما وقد عاد إليهما بعد طول الغربة فى 	
أقصى الصعيد ، وكانا يبيئان له بى أحاديتهما غرفته وينظإن فيا 	
الأثاث ويذ كران ما يجب أن يشرى من المتاع . ويتحاثان بما سيتغير 	
من نظام الدار إذا أقبل هذا الشاب الذى تعله فى المدارس وتعود حياة 	
اللا ، ولا يأكل 	الترف والنعي ، والذى يتكام الفرنسية ويتأنق ف .س 	
كا يأكل أهل الدار جالسا عل الأرض إلى هذه المائدة المنخفضة 	
علما هذه الصينية النحاسية البيضاء فى الأيا العادية ، وعليها تللث 	
الصينية الصفراء النى،لم تكن توضع حى يسرع إليها الصبيان والشبان 	
يتحلفون قراءة من دان عليبا من بعض النقوش قبل أن يرص الحبز عليها 	
رصصا فيخى هأه النقوش إخفاء . 	
ه ولم يكن يأكل بياءيه ها يأكل أهل الدار ، وإما كان 	
