٣١ 	
والابنة المحزونة ؟ بل هل أستطيع أن أعيد الأمر بيننا إلى شيء مما كان 	
عليه قبل هذه الكارثة من هذه المودة السهلة النى لا تكلف فيها ولا تصنع 	
ولا رياء ؟ بل هل أستطيع قبل كل شيء أن أعل اين نحن وإلى أين 	
تمضى ، وماذا تريد بنا أمنا هذه النى تأمر وتنى فى لهجة حازمة صارمة 	
وإيجاز مقتصد لا يقبل حوارا ولا جدالا ؟ ذلك أجدر أن أفكر فيه ، 	
وأحرى أن أسعى إليه . فلأتبعن أى إذن ولأتلطفن ها ، ولأسألبا فى 	
أناة ومودة ورفى حى أعله علمها ، نم أنظر بعد ذلك فيا آتى ، أو فيا 	
تمكن أن نأى من الأمر . 	
كل هذه المعانى تضطرب فى نفسى ، وعينى لا تكاد تفارق هذا 	
الوجه الهادى الذى يدل هدووه عل أن أخبى ما زالت فى تلك الأعماق 	
البعيدة النى كنت فيها منذ حين ، لم يبلغها ضوء الشمس وحرها ، ولم 	
يؤذها مس الأرض وغلظها ، ولم يصل إليها اضطراب الدواجن وما تملا 	
ويمرج وسماع. 	به الجو من نشاط 	
فأمهض متثاقلة مرفقة حى أهبط فناء الدار ألمس أمنا، وما كان 	
أيسر الوصول إلها! فقد اعتزلت غير بعيد من السله وجلست منحنية 	
تعبث فى الأرض بأصابعها عبثا يدل" عل شيء من الذهول ، كأما 	
كانت تناجى ها ثقيلا أو تتبع خاطرا بعيدا : حيى إذا بلغما مسست 	
رأسها بيدى وسألتها مداعبة : ما هذه اللعية البى تلعبين ؟ وهلا دعوتىى 	
ستمي إذا انفردت 	لأكونشريكتك فى اللعب؟! فإن مثل هذه اللعبة لا - " 	
سها لاعبة واحدة . . . 	
ألعب يا ابنتى ؟ قلت : 	قالت وقد رفعت إلى" رأسا حز ينا : أتريبى 	
فما عسى أن تفعل بهذا النراب الذى تذهب فيه أصابعك وتجىء ؟ 	
بها إلى ناحية من الفناء 	نم أسهضتها فل تمتنع عل ، ومضيت 	
