١٣ 	
ألسنة أمثاها من أهل المدن والقرى ، وتكر فى الوعد بالنذور المختلفة 	
لهذا الشيخ وذلك الولى . 	
الدار لا يكف عن التحدث بنشاط أبنائه 	وكان رب 	
وعكوفهم عل الكتب أكثر النهار وشطرا من الليل ، حبى لقدكان 	
لتحدث بذلك إلى زوجه 	يغيظ أصحابه ويملا قلوبهم حسدا ، 	
فيملا قلبها خوفا من الحسد والحاسدين . وكان هذا الرجل الطيب الكريم 	
يجد لذة فى أن يختلس الوقت من حين إلى حين وينهز الفرصة التى 	
فيها أبناؤه عن هذه الغرفة النى رصت فيها الكتب رصا فينسل إلى 	
الغرفة انسلالا كأنه اللص ، ويقف أمام هذه المائدة أو هذه الموائد التى 	
نظمت عليها الكتب تنظيما ، ويلى عل هذه الأسفار نظرات 	
ملؤها الإكبار والإجلال ، وقد يمد يده ى تحفظ واحتياط إلى هذه 	
الكتب فيمسها مسا رفيقا وتمسحها مسحا يسيرا ، كأنه يتبرك بها و يلتمس 	
عندها ما يلتمسه عند الأولياء والقديسين إذا لقيهم أحياء أو زار قبورهى 	
أمواتا . 	
وقد يدفعه حب هذه الكتب وكلفه بها وحاجته الشديدة إلى 	
الاستطلاع إلى شيء من الجراءة ، فيأخذ كتابا منها وينظر فيه ليحفظ 	
عنوانه وليتحدث به إلى أصحابه إن خرج إليهم ، أو ليقرا فيه سطرا أو 	
أسطرا يفهمها أو لا يفهمها ، وهو يؤثر فيا بينه وبين نفسه ألا يفهمها ، 	
فذلك أدى إلى الإعجاب وأشد إمعانا فيا ينبغى للعلم من الغرابة والارتفاع 	
الإعجاب 	عن عقول العامة والجهلاء ، وهو أدنى إلى ما ينبغى من 	
ن . ما «لا يعرف 	سؤلاء الشبان الناشئين الذين يعرفون ويفهمون ويسيغو 	
